MCEBuddy does NOT use the currently logged in user to connect to network shares, it uses its own service account.  Be sure to specify the connection user information (MCEBuddy with a key icon)	MCEBuddy nepoužívá aktuálně přihlášený uživatel pro připojení ke sdílené síťové položky, používá své vlastní účet služby.  Nezapomeňte zadat informace o připojení k uživateli (MCEBuddy s ikonou klíče)
Connection Reminder	Připojení připomenutí
Description	Popis
Path	Cesta
is invalid	je neplatný
Invalid Path	Neplatná cesta
Please supply a task name	Zadejte název úkolu
No name supplied	Není zadaný žádný název
Please enter the 3 digit language code of the Audio track or select <Default> or <Original>	Zadejte kód jazyka 3 číslice zvukovou stopu nebo vyberte <výchozí> nebo <Original>
The 3 digit ISO code for the selected language\r\nMake sure this matches the language code for the audio track in the original recording.\r\nTo get the language code for the audio tracks in the original recorded file, add the file\r\nto the queue and right click on it. A pop up window will open showing the audio details\r\nwhich include the language codes for each audio track.	3 Číslice kódu ISO pro vybrané language\r\nMake si jistá, že to odpovídá kód jazyka pro zvukovou stopu v původním recording.\r\nTo získat kód jazyka pro zvukové stopy v původním zaznamenaného souboru přidejte file\r\nto do fronty a klepněte na něj pravým tlačítkem myši. Popup okno se otevře zobrazení zvuku details\r\nwhich patří kódy jazyků pro každou zvukovou stopu.
Invalid Language Code	Neplatný kód jazyka
No destination directory provided, converted file will be placed in original video directory	Pokud žádný cílový adresář, převedený soubor bude umístěna do původní video adresáře
A task name or section	Název úkolu nebo sekce
already exists\n\rPlease use another name	již exists\n\rPlease použít jiný název
Duplicate Name	Duplicitní název
Engine	Motor
Tasks	Úkoly
Profile	Profil
disposing	odstraňování
Task name	Název úkolu
Give a unique name to this task	Zadejte jedinečný název pro tento úkol
Gives a short description for the selection conversion profile	Poskytuje stručný popis pro výběr profilu konverze
Click to select destination folder	Klepnutím vyberte cílovou složku
Destination	Určení
Select the directory where the converted file will be placed.\r\nLeave this blank to keep the converted file in the same directory as the original video.	Vyberte adresář, kde bude převedený soubor placed.\r\nLeave tomto prázdné udržet převedený soubor ve stejném adresáři jako původní video.
Max width	Max šířka
This will limit the maximum width (in pixels) of the video for the converted file.\r\nTIP: Does not apply if the original file has a width smaller than this number.\r\nIf you want to keep your original video resolution move the slider all the way to the right.	To omezí maximální šířka (v pixelech) video pro převedené file.\r\nTIP: se nepoužije, pokud se původní soubor má šířku menší než tato number.\r\nIf chcete zachovat původní krok rozlišení videa jezdec úplně napravo.
Quality	Kvalita
Ad remover	AD remover
None	Žádný
Get series details from Internet	Získat podrobné informace řada z Internetu
Download additional details about the movie or series from the internet	Stáhnout další podrobnosti o film nebo seriál z Internetu
File name match	Shoda názvu souboru
Recording title match	Záznam utkání titul
Cancel	Storno
OK	Ok
Rename without converting	Přejmenovat bez převodu
Check this option to only rename and copy the original files to the destination folder.\r\nWhen checked, conversion, trimming, audio/video processing and commercial removal will not be available.\r\n\r\nNOTE: Other functions like matching filters, extracting subtitles, saving metadata and commercial detection (saving EDL file)\r\nwill still be available with this option checked.\r\nIf you want to move instead of copy, check the Skip copying original option in Expert Settings on this page or select\r\nDelete original file in the main settings page.	Kontrola zaškrtnuta tato volba pouze přejmenovat a zkopírovat původní soubory do cílové folder.\r\nWhen, konverzi, úpravu, zpracování audio a video a komerční odstranění nebude available.\r\n\r\nNOTE: další funkce, jako odpovídající filtry, extrahování titulky, ukládání metadata a komerční detekce (ukládání EDL souboru) \r\nwill stále k dispozici s tuto možnost checked.\r\nIf chcete přesunout místo kopie, zkontrolujte přeskočit kopírování původní volbu v expertní nastavení na této stránce nebo select\r\nDelete původní soubor v hlavním nastavení stránky.
Rename and sort by video information	Přejmenovat a řadit podle informací video
Renames the converted file and places it in a new directory based on the show/series information when available\r\n(e.g. ShowName\\ShowName-SXXEYY-EpisodeName-RecordDate)	Přejmenuje převedený soubor a umístí jej do nového adresáře založené na informacích, zobrazit/série když available\r\n (např. ShowName\\ShowName-SXXEYY-EpisodeName-RecordDate)
Enter the username and password to access folders that are on a network drive or a different computer	Zadejte uživatelské jméno a heslo pro přístup k složky, které jsou na síťové jednotce nebo v jiném počítači
Organize by seasons	Uspořádat podle ročních období
Organize folders by Showname and Season when available (Media Center/XBMC/Plex compatible naming convention)\r\n(e.g. Showname\\Season XX\\SXXEYY-Episode Name)	Uspořádat složky podle Showname a sezóně, když dostupné (Media Center/XBMC/Plex kompatibilní konvence) \r\n (např. Showname\\Season XX\\SXXEYY-epizoda jméno)
Audio language	Jazyk zvukového záznamu
Advanced Settings	Upřesnit nastavení
General Settings	Obecné nastavení
Conversion Task	Konverze úkol
Password	Heslo
Confirm Password	Potvrzení hesla
Domain / computer name	Doména / název počítače
<Optional> Enter if remote computer or network drive uses a Domain for authentication.\r\nDo NOT enter your workgroup here. Leave this blank if you're using a workgroup.	<Optional>Enter, pokud vzdálený počítač nebo síťové jednotky používá doménu na authentication.\r\nDo zadejte své pracovní skupiny. Pole necháte prázdné, pokud používáte pracovní skupiny.
User name	Uživatelské jméno
Enter the username to access the remote computer or network drive	Zadejte uživatelské jméno pro přístup vzdáleného počítače nebo síťové jednotky
Enter the password to access the remote computer or network drive	Zadejte heslo pro přístup vzdáleného počítače nebo síťové jednotky
Network Connection User Credentials	Síťová připojení uživatele pověření
Password Mismatch	Hesla nesouhlasí
Passwords do not match, please reenter the passwords	Hesla se neshodují, délka hesla
Hour	Hodina
Minute	Minuta
Wake	Probudit
Start	Spustit
Resume	Životopis
Pause	Pauza
Stop	Stop
Language	Jazyk
Pause conversion tasks	Pozastavení převodu úkolů
Resume conversion tasks	Pokračovat v převodu úkolů
Please enter a valid time	Prosím zadejte platný čas.
Invalid Time	Neplatný čas
Stop time is after Start time. Assuming the Stop time is during the next day, is that correct?	Čas ukončení je po čase zahájení. Za předpokladu, že doba prostoje je během příštího dne, je to tak?
Time Check	Kontrola času
Only select this option if MCEBuddy has been converting your files reliably for an acceptable period of time. Do you wish MCEBuddy to delete each original file once it has been converted?	Tuto možnost vyberte pouze je-li MCEBuddy už byla převádí soubory spolehlivě přijatelnou dobu. Rádi MCEBuddy do každého původní soubor odstranit, jakmile byla převedena?
Confirm delete originals?	Potvrdit odstranění originály?
MCEBuddy will monitor these directories for video files to convert automatically	MCEBuddy bude sledovat tyto adresáře pro video soubory automaticky převést
Conversion tasks	Konverze úkoly
Delete original file	Odstranit původní soubor
Deletes the original recording after a successful conversion	Odstraní původní nahrávka po úspěšné konverze
Min age before conversion (hours)	Věk min před převodem (hodiny)
Minimum hours to wait before converting each file after the file is added to the queue	Minimální doba čekání před převodem každý soubor po souboru je přidání do fronty
Use this to change the language of the text on the screen	Zde můžete změnit jazyk zobrazení textu na obrazovce
Concurrent conversions	Souběžných převodů.
Number of simultaneous conversions MCEBuddy can start\r\nNOTE: You need large amounts of free disk space and processor time for more than 2 simultaneous conversions	Počet souběžných převodů MCEBuddy mohou start\r\nNOTE: potřebujete velké množství volného místa a procesoru času pro více než 2 souběžných převodů
Logging level	Úroveň protokolování
Error	Chyba
Warning	Varování
Information	Informace
Debug	Ladění
Log conversion jobs	Konverze protokolu pracovní místa
Save a log file for each conversion in the \'logs\' directory where where MCEBuddy is installed\r\n(e.g. C:\\Program Files\\MCEBuddy2x\\logs)	Uložit soubor protokolu pro každý převod \'logs\' kde kde MCEBuddy je installed\r\n (např. C:\\Program Files\\MCEBuddy2x\\logs)
Allow sleep	Povolit režim spánku
If unchecked, it prevents the system from entering sleep while converting	Je-li tato volba zaškrtnuta, to zabrání systému do režimu spánku při převodu
Stop at	Zastavit na
No new conversions would be started after this time	Po této době by nespustí žádné nové převody
minute	minuta
hour	hodina
If checked MCEBuddy will wake the system from sleep\r\nat the specified Start time and enabled days of the week.	Je-li zaškrtnuto MCEBuddy se probudit systém z sleep\r\nat zadaný čas zahájení a povolené dny v týdnu.
Start at	Začít od
MCEBuddy will start new conversions between the Start and Stop time.\r\n\r\nThe Start time will be used for the enabled days of the week, whereas\r\nthe End time will be used either for the same day or\r\nfor the next day if the End time is after the Start time.	MCEBuddy začne nové převody mezi Start a Stop time.\r\n\r\nThe počáteční čas bude použit pro povolené dny v týdnu, whereas\r\nthe konec, čas bude použity buď pro stejný den or\r\nfor druhý den, je-li koncový čas po čase zahájení.
Delete	Odstranit
Add	Přidat
Change	Změnit
Archive original file	Původní soubor archivu
Domain name	Název domény
Stops the monitor and conversion tasks and opens a page to configure MCEBuddy	Zastaví monitoru a převodu úkolů a otevře se stránka konfigurovat MCEBuddy
Creates a folder called \'MCEBuddyArchive\' where the original file is located\r\nand moves the orginal file in this directory after a successful conversion.\r\n\r\nThis folder name and location be changed in the System Settings page.	Vytvoří složku s názvem \'MCEBuddyArchive\' kde je původní soubor located\r\nand přesune původní soubor v tomto adresáři poté, co úspěšné conversion.\r\n\r\nThis název a umístění složky změnit na stránce nastavení systému.
Debug - detailed logs, helps trace conversion problems\r\nInformation - logs basic information about conversion\r\nWarning - log potential issues or critical failures only\r\nError - log critical failures only	Ladění - podrobné protokoly, pomáhá trasování problems\r\nInformation - protokoly základní informace o conversion\r\nWarning - log potenciální problémy při převodu nebo kritické selhání only\r\nError - log kritické chyby pouze
Select the conversion profile associated with this task. The conversion profile represents the output format and quality for the converted file.\r\nHigher quality conversions take longer to convert. Reccomended Default: MP4 High Quality or MP4 Normal.\r\n\r\nTIP: Refer to the MCEBuddy Guide for advanced parameters to tweak conversion profiles or to create your own conversion profiles	Vyberte profil konverze, související s tímto úkolem. Konverze profilu představuje výstupní formát a kvalitě za převedené file.\r\nHigher kvalitu, kterou převody trvat déle k převedení. Výchozí hodnota Reccomended: Vysoce kvalitní MP4 nebo MP4 Normal.\r\n\r\nTIP: v příručce MCEBuddy pro upřesňující parametry vymodelovat konverze profily, nebo vytvořit vlastní převod profilů
Select the program MCEBuddy will use to strip out any commercials while converting the video.\r\nSet to 'None' to leave the commercials in the converted video.\r\n\r\nTIP: To use ShowAnalyzer instead of Comskip, please download and install ShowAnalyzer.\r\nShow Analyzer version 1.0 and greater supported.	Vyberte program, MCEBuddy použije vyřadit jakýkoliv reklamy při převodu video.\r\nSet na "None" opustit reklamy v převedeném video.\r\n\r\nTIP: používat ShowAnalyzer místo Comskip, Stáhněte si a nainstalujte ShowAnalyzer.\r\nShow Analyzer verze 1.0 a vyšší podporovány.
Used to change the video quality of the converted file, normal is 1.\r\nA higher number will improve quality but will take more time for conversion.\r\nA smaller number will reduce the quality but speed up the conversion.	Používá se ke změně kvalitu videa převedeného souboru, normální je 1.\r\nA vyšší číslo zvýší kvalitu, ale bude trvat déle, conversion.\r\nA menší číslo sníží kvalitu ale zrychlit konverzi.
Enter pattern to match filenames for this task (e.g. *.wtv will convert all files ending with .wtv)\r\nPrefix pattern with ~ to skip the match (e.g. *.*;~*.wtv will process all files except those ending with .wtv)\r\nSeparate multiple patterns with ; (e.g. *.wtv;ncis*;~ncis miami*) will process all .wtv files and all files starting with ncis but not those starting with ncis miami\r\n\r\nYou can use regular expressions to match the pattern by starting with regex:	Zadejte vzor odpovídající názvy souborů pro tento úkol (např. *.wtv převede všechny soubory končící s .wtv)\r\nPrefix vzorem s ~ Přeskočit na zápas (např. *. *; ~*.wtv zpracuje všechny soubory s výjimkou těch končí s .wtv)\r\nSeparate více vzorů s; (např. *.wtv; ncis *; ~ ncis miami *) zpracuje všechny soubory .wtv a všechny soubory začínající ncis, ale ne ty, které začínající ncis miami\r\n\r\nYou může použít regulární výrazy odpovídají vzoru pomocí regex:
Enter pattern to match show/series titles for this task (e.g. Simpson* will convert all files that have a show title starting with Simpson)\r\nPrefix pattern with ~ to skip the match (e.g. *;~Simpson* will process all show titles except those that start with Simpson)\r\nSeparate multiple patterns with ; (e.g. Simpson*;House*) or (e.g. Simpson*;NCIS*;~NCIS Miami*)\r\n\r\nYou can use regular expressions to match the pattern by starting with regex:	Zadejte vzorek Ukázat/seriálu tituly pro tento úkol (např. Simpson * převede všechny soubory, jejichž název pořadu, počínaje Simpson) vzor \r\nPrefix s ~ Přeskočit na zápas (např. *; ~ Simpson * zpracuje všechny tituly s výjimkou těch, které začínají Simpson) \r\nSeparate více vzorků; (např. Simpson *;House*) nebo (např. Simpson *;NCIS*; ~ NCIS Miami *) \r\n\r\nYou lze použít regulární výrazy odpovídají vzoru pomocí regex:
This can be used to override the default Audio Language when there are multiple audio languages in a recording.\r\nTo get the list of the Audio Languages in a recording, right click on the file in the queue and select MediaInfo.\r\n\r\n<Default> will try to keep all audio tracks if supported or let the encoder choose the default audio track\r\n<Original>, if available, will use the original [non-dubbed] recording language	To lze přepsat výchozí jazyk zvuku, když existuje více jazyků zvuku v recording.\r\nTo si seznam jazyků zvuku v nahrávání, klepněte pravým tlačítkem myši na soubor ve frontě a zvolte MediaInfo.\r\n\r\n <Default>bude snažit udržet všechny zvukové stopy, pokud podporuje nebo nechat kodér vybrat výchozí zvukový track\r\n <Original>, je-li k dispozici, použije původní jazyk [dabing] nahrávka
Enter '[video]' or leave blank to convert all video files\r\nEnter pattern to match filenames for this location (e.g. *.wtv will convert all files ending with .wtv)\r\nPrefix pattern with ~ to skip the match (e.g. *.*;~*.wtv will process all files except those ending with .wtv)\r\nSeparate multiple patterns with ; (e.g. *.wtv;ncis*;~ncis miami*) will process all .wtv files and all files starting with ncis but not those starting with ncis miami	Zadejte "[video]" nebo ponechejte prázdné převést všechny video files\r\nEnter vzoru odpovídají názvy souborů pro toto umístění (např *.wtv převede všechny soubory končící s .wtv)\r\nprefix vzorem s ~ Přeskočit zápas (např |. |; ~*.wtv zpracuje všechny soubory kromě těch končící .wtv)\r\nseparate mnoha provedeních s; (např. *.wtv; ncis |; ~ ncis miami |) zpracuje všechny soubory WTV a všechny soubory začínající na ncis ale ne ty začínající ncis miami
MCEBuddy Settings	MCEBuddy nastavení
MCEBuddy does NOT use the currently logged in user to connect to network shares, it uses its own service account.  Be sure to specify the connection user information [MCEBuddy with a key icon]	MCEBuddy nepoužívá aktuálně přihlášený uživatel pro připojení ke sdílené síťové položky, používá své vlastní účet služby.  Nezapomeňte zadat informace o připojení k uživateli [MCEBuddy s ikonou klíče]
Please supply a source name	Prosím zadejte název zdroje
Please supply a search path name	Prosím zadejte název cesty hledání
A source name or section	Název zdrojového nebo sekce
already exists. Please use another name	již existuje. Použijte prosím jiný název
Monitor name	Název monitoru
Give this a location a unique name	Dej to na místo jedinečný název
Monitor path	Cesta k monitoru
Select the directory that MCEBuddy will monitor in the background for new video files to convert automatically	Vyberte adresář, který bude sledovat MCEBuddy na pozadí pro nové video soubory automaticky převést
Click to select the folder to monitor	Klepnutím vyberte složku, kterou chcete sledovat
Search pattern	Vyhledávací vzor
SourceForm	SourceForm
Monitor Location	Umístění monitoru
Normal	Normální
MCEBuddy GUI: pipeProxy engine connection error	MCEBuddy GUI: Chyba připojení motoru pipeProxy
MCEBuddy GUI: Unable to create pipe to MCEBuddy service	MCEBuddy GUI: Nepodařilo se vytvořit kanál ke službě MCEBuddy
The MCEBuddy service is unavailable. Please start from Windows control panel or check engine connection.	MCEBuddy služba není k dispozici. Začít od ovládacích panelech systému Windows nebo zkontrolovat připojení motoru.
Announcement	Oznámení
New version 	Nová verze 
available	k dispozici
New BETA version 	Nová verze BETA 
Click here to download new version of MCEBuddy	Klepnutím sem stáhněte novou verzi MCEBuddy
Click here to open link	Klepnutím sem otevřete odkaz
Idle	Nečinný
Closing	Zavírání
MCEBuddy GUI: Unable to update tasks	MCEBuddy GUI: Nelze aktualizovat úkoly
MCEBuddy GUI: Unable to start MCEBuddy service	MCEBuddy GUI: Nelze spustit službu MCEBuddy
MCEBuddy GUI: Unable to stop MCEBuddy service	MCEBuddy GUI: Nelze zastavit službu MCEBuddy
MCEBuddy GUI: Unable to cancel job	MCEBuddy GUI: Nelze zrušit úlohu
Warning: Networked files will be accessed using the logon credentials of the MCEBuddy Service, not the currently logged on user. You can manually specify the network credentials from the Settings -> Expert Settings page in MCEBuddy.	Upozornění: Síťové soubory bude přístupná pomocí pověření přihlašovací služby MCEBuddy, nikoli aktuálně přihlášeného uživatele. V MCEBuddy můžete ručně určit síťová pověření od nastavení-> expertní nastavení stránky.
Credential Warning	Pověření varování
Status	Stav
MCEBuddy GUI: Unable to add job	MCEBuddy GUI: Nelze přidat práci
MCEBuddy GUI: Unable to get pipe active status	MCEBuddy GUI: Nepodařilo se získat aktivní stav kanálu
The conversions must be stopped to change settings. Stop the conversions?	Převody musí být zastaven změnit nastavení. Zastavte převody?
Stop Engine	Zastavení motoru
MCEBuddy GUI: Unable to stop MCEBuddy service from settings click	MCEBuddy GUI: Nelze zastavit službu MCEBuddy z nastavení klepněte na tlačítko
MCEBuddy GUI: Unable to rescan files	MCEBuddy GUI: Nelze prohledat soubory
MCEBuddy GUI: Unable to open link	MCEBuddy GUI: Nepodařilo se otevřít odkaz
Close	Zavřít
Close this window, MCEBuddy will keep running in the background	Zavřít toto okno, MCEBuddy poběží v pozadí
If you like MCEBuddy, please click here to Donate - THANKS	Chcete-li MCEBuddy, klepnutím sem Darujte - díky
Click here to like MCEBuddy on facebook	Chcete-li jako MCEBuddy na Facebooku
Click here to open MCEBuddy website	Klepnutím sem otevřete web MCEBuddy
Rescan	Znovu načíst
Forces the MCEBuddy to recheck the Monitor locations for new video files to convert	Síly MCEBuddy znovu zkontrolovat umístění monitoru pro nové video soubory k převodu
Monitor locations	Umístění monitoru
Settings	Nastavení
Select the file(s) in the queue to delete	Vybrat soubory ve frontě k odstranění
Manually add video file(s) to the queue to convert	Do fronty k převedení ručně přidejte video soubory
Start the MCEBuddy monitor and conversion tasks	Spuštění úlohy monitoru a konverze MCEBuddy
Stop the MCEBuddy monitor and conversion tasks	Zastavit MCEBuddy monitoru a konverze úkoly
There is a new version!	Je tu nová verze!
High	Vysoká
Low	Nízká
Priority	Priorita
High priority - convert faster but may make other running applications unresponsive\r\nLow priority - convert in the background but reduced interference with other running applications	Nejdůležitější - převést rychleji, ale může učinit jiné spuštěné aplikace unresponsive\r\nLow prioritu - převést v pozadí, ale snížení interference s jinými spuštěné aplikace
A task is a conversion template that contains a conversion profile and various other conversion parameters.\r\nEach file added to the queue will be processed and converted by each of these tasks.\r\nRefer to the MCEBuddy Guide for more details on how tasks work.	Úkol je konverze šablona, která obsahuje profilem převodu a různé jiné parameters.\r\nEach konverze souboru přidána do fronty budou zpracovány a převeden podle každého z těchto tasks.\r\nRefer MCEBuddy příručce podrobnější informace o funkcích úkoly.
Getting started	Začínáme
Click here for MCEBuddy guide	Klepnutím sem zobrazíte Průvodce MCEBuddy
Logs	Protokoly
Click to open log folder	Klepnutím sem otevřete složku protokolu
MCEBuddy Status	MCEBuddy Status
add	Přidat
delete	Odstranit
paypal-donate	PayPal-Darujte
stop	Stop
OUTPUT: ConsoleOuput received NULL data	VÝSTUP: ConsoleOuput obdržel NULL data
hours	hodin
minutes	minut
second	sekunda
seconds	sekundy
Starting	Spouštění
Comskip advertisement scan - Pass 1	Comskip reklama skenování - projít 1
Comskip advertisement scan - Pass 2	Comskip reklama skenování - Pass 2
Cutting commercials from video	Řezání reklam z videa
Cutting commercials from video - segment 	Řezání reklam z videa - segment 
Merging commercial free segments into new video	Sloučení komerční zdarma segmenty do nové video
Moving converted file to destination	Přesun převedený soubor do cílového
Checking for disk space	Kontrola místa na disku
Getting show information and banner from Internet sources	Získávání zobrazit informace a nápis z Internetu zdrojů
Copying source file to working directory	Kopírování zdrojového souboru do pracovního adresáře
Remuxing recording	Remuxing nahrávání
ShowAnalyzer advertisement scan	ShowAnalyzer reklama skenování
Comskip advertisement scan	Comskip reklama skenování
Analyzing video information	Analýza informací o video
Converting	Probíhá převod
Removing commercials	Odstranění reklamy
Writing show information	Zobrazit informace o psaní
Renaming file using show information	Přejmenování souboru pomocí zobrazení informací
Success - All done!	Úspěch - Hotovo!
Muxing streams	Muxing proudy
Fallback remux	Náhradní remux
Correcting audio delay	Oprava zpoždění zvuku
Converting video file - Pass 1	Převod video souborů - projít 1
Converting video file - Pass 2	Převod video souborů - Pass 2
Converting video file	Převod souboru videa
Audio Track	Zvuková stopa
Impaired	Postižené
Channels	Kanály
Codec	Kodek
Video	Video
Duration	Doba trvání
Height	Výška
Width	Šířka
Audio	Zvuk
Name	Jméno
Subtitle	Podtitul
Volume	Hlasitost
Enable custom file renaming	Povolit přejmenování vlastních souborů
Enable this to enter a custom pattern to rename converted files and folders. Enter the custom pattern in the box below.\r\n\r\nExample:\r\nTVShows\%showname%\Season %season%\%showname% - S%season%##E%episode%## - %episodename% - %airyear%_%airmonth%_%airday%\r\n\r\nWill produce:\r\nTVShows\CSI\Season 1\CSI - S01E02 - Best of times - 2012_01_06.<ext>\r\n\r\nExample:\r\nRecording\%ismovie%<Movie\%showname%,TVShows\%showname%\Season %season%\%showname% - S%season%##E%episode%##>-Converted\r\n\r\nWill produce (for a movie)\r\n    Recording\Movies\Star Wars-Converted.<ext>\r\nOR (for non movies)\r\n    Recording\TVShows\CSI\Season 1\CSI - S01E02-Converted.<ext>\r\n\r\nRefer to the MCEBuddy advanced documentation for a list of all the pattern commands.	Povolte tuto k zadání vlastního vzorku přejmenovat převedené soubory a složky. Zadejte vlastní pole below.\r\n\r\nExample:\r\nTVShows\%showname%\Season %season%\%showname% - S % sezóna % ##E % epizoda % ##-% episodename % - %airyear%_%airmonth%_%airday%\r\n\r\nWill produkty: \r\nTVShows\CSI\Season 1\CSI - S01E02 - nejlepší časy - 2012_01_06.<ext>\r\n\r\nExample:\r\nRecording\%ismovie% < Movie\%showname%,TVShows\%showname%\Season %season%\%showname% - \r\n Recording\Movies\Star S%season%##E%episode%##>-Converted\r\n\r\nWill plodin (pro film) války převeden. <ext>\r\nOR (pro jiné filmy) \r\n Recording\TVShows\CSI\Season 1\CSI - S01E02-převeden.<ext>\r\n\r\nRefer k MCEBuddy postoupil dokumentaci k seznam všech příkazů programu vzor.
ShowAnalyzer not found.\nPlease download and install ShowAnalyzer.	ShowAnalyzer nebyl nalezen. \nPřipojte stáhnout a nainstalovat ShowAnalyzer.
ShowAnalyzer Missing	Chybí ShowAnalyzer
Invalid language code, reverting to <Default> language	Neplatný jazyk kód, návrat k <výchozí> jazyka
Cut start	Řez start
Cut end	Řez konec
This specifies the number of seconds to cut from the start of the recording (BEFORE removing the ads)	Tato hodnota určuje počet sekund od začátku nahrávání (před odebráním reklam)
This specifies the number of seconds to cut from the end of the recording (BEFORE removing the ads)	Tato hodnota určuje počet sekund od konec záznamu (před odebráním reklam)
Send an eMail after each conversion.	Pošlete E-mail po každém převodu.
Send eMail	Odeslat eMail
SMTP Server Name	Název serveru SMTP
Enter the outgoing eMail (SMTP) server address here\r\ne.g. smtp.gmail.com	Zadejte odchozí E-mail (SMTP) server adresu here\r\ne.g. SMTP.Gmail.com
Port	Přístav
Enter the SMTP server port	Zadejte port SMTP serveru
Use SSL	Použít SSL
Check this if you SMTP server uses SSL	Zaškrtněte, pokud jste SMTP server používá protokol SSL
e-Mail Settings	Nastavení e-mailu
From <e-Mail>	Od <e-Mail>
Enter the senders (From) eMail address here	Zadejte odesílatelů (od) e-mailové adresy zde
To <e-Mails>	Na <e-Mails>
Enter the recipients (To) eMail address here.\r\nSeparate multiple recipients with a semicolon (;)	Zadání příjemců (K) e-mailové adresy here.\r\nSeparate více příjemcům středníkem (;)
Send eMail on successful conversion	Poslat eMail na úspěšnou konverzi
Send eMail on failed conversion	Poslat eMail na Neúspěšný převod
Send eMail on cancelled conversion	Poslat eMail na zrušené konverze
Send eMail on adding a conversion to the queue	Poslat eMail na přidání konverze do fronty
Please enter a valid server address	Zadejte prosím platnou adresu serveru
Invalid SMTP Server	Neplatný Server SMTP
Please enter a valid server port	Zadejte prosím platný název serveru portů
Invalid SMTP Port	Neplatný Port SMTP
Please enter a valid From eMail address	Zadejte prosím platný od e-mailové adresy
Invalid eMail Address	Neplatná e-mailová adresa
Please enter valid To eMail addresses	Prosím zadejte platné e-mailové adresy
Username	Uživatelské jméno
<Optional> Enter the username for the eMail server authentication	<Optional>Enter uživatelské jméno pro ověřování serveru e-mailu
<Optional> Enter the password for the eMail server authentication	<Optional>Enter heslo pro ověření serveru e-mailu
MCEBuddy unable to download series information	MCEBuddy nemůže stáhnout informace o seriálu
MCEBuddy successfully converted a video	MCEBuddy úspěšně převést video
Source Video	Zdroj videa
Converted Video	Převedené Video
Converted At	Převedeno na
MCEBuddy failed to converted a video	MCEBuddy se nepodařilo převést video
Failed At	Selhání
MCEBuddy cancelled a video conversion	MCEBuddy zrušen video konverze
Cancelled At	Zrušeno na
Working	Pracovní
Test	Zkouška
Testing	Testování
Click this button to test the eMail server settings	Klepnutím na toto tlačítko otestovat nastavení serveru e-mailu
MCEBuddy will send an eMail to test the server settings.\r\nThis can take upto 60 seconds.\r\nMCEBuddy may be unresponsive during this period.	MCEBuddy odešle E-mail testovat settings.\r\nThis serveru může vzít překvapená 60 seconds.\r\nMCEBuddy může být poslána v tomto období.
Test eMail	Testovac├¡ eMail
MCEBuddy Test eMail	MCEBuddy testovac├¡ eMail
MCEBuddy - Have a great day!	MCEBuddy - hezký den!
Send eMail test successful	Odeslat zkušební e-mailů úspěšné
Send eMail test failed! Please check your settings and internet connectivity	Odešlete E-mail testu selhal! Zkontrolujte nastavení a připojení k Internetu
Test eMail Success	Testovac├¡ eMail úspěch
Test eMail Failed	Testovac├¡ eMail se nezdařilo
Send eMail on start of conversion	Poslat eMail na zahájení převodu
MCEBuddy started a video conversion	MCEBuddy spustit video konverze
Conversion Started At	Konverze V
Yes (Comskip)	Ano (Comskip)
Yes (ShowAnalyzer)	Ano (ShowAnalyzer)
Atleast one Conversion Task must be enabled	Alespoň jeden úkol převod musí být povoleno
Disable	Zakázat
Enable	Povolit
Rename	Přejmenovat
Move	Přesun
Up	Nahoru
Down	Dolů
Slow Remuxing	Pomalé Remuxing
Extracting closed captions	Extrahování skryté titulky
Validating closed captions	Ověření skryté titulky
Extracting subtitles	Extrahování titulky
Trimming closed captions	Oříznutí uzavřené titulky
Extract subtitles and closed captions	Extrahovat titulky a titulky
Field	Pole
Channel	Kanál
Enable this to extract Closed Captions, Subtitles and Teletext from\r\nWTV, DVR-MS, TS, MP4, MKV and other supported files.\r\n\r\nIt is saved as a Subtitle (SRT) file.	Povolte tuto extrahovat titulky, titulky a Teletext from\r\nWTV, DVR-MS, TS, MP4, MKV a další podporované files.\r\n\r\nIt je uložen jako soubor titulků (SRT).
Enable this to set advanced options for Closed Captions extraction\r\nField - 1 or 2\r\nChannel - 1 or 2\r\n\r\nDefault: Field 1, Channel 1	Povolte tuto můžete upřesnit možnosti pro skryté titulky extraction\r\nField - 1 nebo 2\r\nChannel - 1 nebo 2\r\n\r\nDefault: pole 1, 1 kanál
Subtitle offset	Offset titulků
Enter the number of seconds (+ve / -ve) to adjust the subtitles sync with video	Zadejte počet sekund (+ ve / - a) nastavte titulky synchronizace s videem
Re-ReMuxing due to audio error	Re-ReMuxing k chybě zvuku
Save the poster and show information (metadata) in a MC/XBMC compatible NFO file (XML format)	Uložte plakát a zobrazit informace (metadata) v MC/XBMC kompatibilní NFO soubor (formát XML)
Check this box to save the show information (metadata) in the converted file.\r\nThis only works for files that support metadata tags like MP4, MKV, WTV etc.\r\n\r\nNOTE: Uncheck this box if you're facing issues with some devices such as older TV's which have problem reading metadata.	Zaškrtněte toto políčko, chcete-li uložit zobrazit informace (metadata) převedené file.\r\nThis jen pracuje pro soubory, které podporují značky metadata jako MP4, MKV, WTV etc.\r\n\r\nNOTE: zrušte zaškrtnutí tohoto políčka, je-li to čelí problémy s některými zařízeními jako je starší televize, které mají problém čtení metadat.
Atleast one day of the week must be enabled	Minimálně musí být povolen jeden den v týdnu
Invalid Days of Week	Neplatný dny týdne
Invalid day of week found in configuration file	Neplatný den týdne v konfiguračním souboru
Scheduling	Plánování
Remuxing to	Remuxing na
Part	Část
Rest your mouse on any button, box or item to get Instant Help on it.\n\nFor more information on how to use, troubleshoot or get support for MCEBuddy click on the <Getting Started> link on the top right corner.\n\nDonations are always welcome :) Enjoy!\n\n  - Ramit, Derek & Goose	Zbytek myší na tlačítka, pole nebo položku získat okamžitou pomoc na it.\n\nFor další informace o způsobu použití, řešení a získat podporu pro MCEBuddy klepněte na odkaz < Začínáme > na horním pravém corner.\n\nDonations jsou vždy vítány :) Užijte si! \n\n - Ramit, Derek & Husa
Welcome to MCEBuddy	Vítejte na MCEBuddy
Multichannel audio	Vícekanálový zvuk
Check to allow multi-channel audio if the source video supports it.\r\nBy default the audio is limited to 2 channels (stereo).	Kontrola aby Vícekanálový zvuk, pokud zdrojový video podporuje it.\r\nBy výchozí zvuk je omezena na 2 kanály (stereo).
Dynamic Range Compression (DRC)\r\nWhen the source is an AC3 audio, enabling DRC will\r\nreduce the difference between the loud and the soft\r\nsounds making the audio track more even.\r\nIf you have a multi-channel audio recording and you\r\nfeel the volume is too soft, checking this box might help.	Dynamic Range \r\nWhen kompresi (DRC) zdrojové je AC3 audio, umožňuje DRC will\r\nreduce rozdíl mezi hlasitě a soft\r\nsounds, takže zvukovou stopu další even.\r\nIf máte multi-kanálové audio nahrávání a you\r\nfeel svazek je příliš měkká, zaškrtnutí že tohoto políčka by mohly pomoci.
FPS	FREKVENCE SNÍMKŮ
Logfile age (days)	Logfile stáří (dny)
Maximum number of days to keep the logfiles before deleting them.\r\nSet to 0 to keep the logs forever.	Maximální počet dní, aby logu před odstraněním them.\r\nSet na hodnotu 0, aby protokoly navždy.
DVRMS Remuxing	DVRMS Remuxing
Fast Remuxing	Rychlé Remuxing
Byte stream remuxing	Remuxing proud bajtů
Disable cropping	Zakázat oříznutí
Check this to disable cropping the video automatically during conversion.\r\nCropping is used to remove the "black bars" in the video (top, bottom, left or right).\r\nUse this option if the video picture is getting cut on any side or if the final picture is looking stretched or distorted.	Zkontrolujte to vypnout oříznutí video automaticky během conversion.\r\nCropping se používá k odstranění "černé pruhy" na videu (nahoře, dole, vlevo nebo right).\r\nUse tuto možnost pokud je získávání video obrázek na každé straně, nebo je-li konečný obraz roztažený nebo zkreslený.
Only detect Ads	Pouze detekovat reklamy
Check this if you want MCEBuddy to detect the ads (commercials) but NOT cut them from the video.\r\nWhen this option is enabled, MCEBuddy will create an EDL file along with the converted file that specifies the locations of ads in the converted video.\r\nAlso, for MP4, M4V and MKV files MCEBuddy will create Chapters to mark the end of commercials.	Zaškrtněte, pokud chcete MCEBuddy zjistit reklamy (reklamy), ale ne vyjmout je z video.\r\nWhen je tato možnost povolena, vytvoří MCEBuddy EDL souboru spolu s převedený soubor, který určuje umístění reklamy v převedeném video.\r\nAlso, MP4, M4V a MKV soubory MCEBuddy bude vytvářet kapitoly konec reklam.
Download information	Stáhnout informace o
Correction	Oprava
Click here to correct the Show title and force use of a specific TVDB series id or IMDB movie id\r\nto lookup additional metadata from the internet.	Klepnutím sem opravte název pořadu a vynutit použití určité TVDB řady id nebo IMDB film id\r\nto vyhledávání další metadata z Internetu.
Check this to download additional information from the internet about the show like a banner file, episode, season etc	Toto zaškrtněte, aby stáhnout další informace z Internetu o show jako soubor nápis, epizoda, sezona atd
Profile Error	Chyba profilu
Cannot find selected profile in profiles.conf	Nelze najít vybraný profil v profiles.conf
Invalid Profile	Neplatný Profil
Please select a valid profile	Zvolte prosím platný profil
The MCEBuddy Engine has crashed. Please send mcebuddy.log to the developers	MCEBuddy motor se selhal. Zašlete prosím mcebuddy.log vývojáři
Comskip INI	Comskip INI
Select the custom Comskip INI file to use for this conversion task\r\nLeave this blank to use the default Comskip INI file for advertisement removal	Vyberte vlastní soubor Comskip INI využívat tento prázdný použít výchozí soubor Comskip INI pro odstranění reklamy pro tento převod task\r\nLeave
Click to select custom Comskip INI file	Klepnutím vyberte vlastní soubor Comskip INI
Select the folder for working with temporary files. Make sure there is enough empty space on the drive.\r\nLeave this blank to use the default temp folder in the installation folder.	Vyberte složku pro práci s dočasné soubory. Ujistěte se, že je dost prázdné místo na drive.\r\nLeave tento prázdný používat výchozí složku temp v instalační složce.
Select the folder for working with temporary files. Make sure there is enough empty space on the drive.\r\nThis overrides the temp folder specified in the Settings -> Expert Settings page.	Vyberte složku pro práci s dočasnými soubory. Přesvědčte se, zda existuje že dostatek volného místa na drive.\r\nThis přepíše dočasné složky zadané v nastavení-> expertní nastavení stránky.
Click to select temp working folder	Klepnutím vyberte dočasnou pracovní složku.
Temp folder	Dočasné složky
Space check	Kontrola místa
When enabled MCEBuddy will check for enough free space for the conversion (destination and temp).\r\nUncheck this if you have are having trouble with network drives or have extraordinarily large video files.	Kdy bude povoleno MCEBuddy kontrolovat dostatek volného místa pro konverzi (cíl a temp).\r\nUncheck to máte-li se s problémy s síťové jednotky nebo mají mimořádně velké video soubory.
MCEBuddy Windows Event Logs	Protokoly událostí systému Windows MCEBuddy
Events	Události
Click here to open the MCEBuddy Windows Event Logs	Klepnutím sem otevřete MCEBuddy protokoly událostí systému Windows
Enable UPnP	Povolení UPnP
Check this to enable UPnP. This allows access to MCEBuddy engine from outside the network.\r\nThis needs to be checked if you're using a mobile/standalone MCEBuddy client to access MCEBuddy.	Zaškrtnutím umožníte UPnP. To umožňuje přístup k MCEBuddy motor z mimo network.\r\nThis je třeba zkontrolovat, pokud používáte klienta MCEBuddy mobilní/samostatný přístup MCEBuddy.
Click here to connect to another MCEBuddy engine	Zde se připojit k jinému MCEBuddy motor
MCEBuddy Remote Engine Connection	MCEBuddy vzdálené připojení a motor
Engine Name	Název motoru
Engine Port	Motor Port
Enter the Name or IP Address of the MCEBuddy engine you want to connect to	Zadejte název nebo IP adresu MCEBuddy motoru, které chcete připojit k
Enter the TCP Port number of the MCEBuddy Engine you want to connect to	Zadejte číslo portu TCP MCEBuddy motoru, které chcete připojit k
Enter the TCP Port number of the MCEBuddy Engine you want to connect to (1 to 63355)	Zadejte číslo portu TCP MCEBuddy motoru, které chcete připojit k (1 k 63355)
Invalid Name/Port	Neplatný název/Port
Please enter a valid Engine Name and Engine Port Number	Zadejte platný název motoru a motor číslo portu
Error Stopping Engine	Chyba zastavení motoru
Unable to stop MCEBuddy engine, settings may not be saved. Do you want to continue?	Nelze zastavit MCEBuddy motoru, nastavení nelze uložit. Chcete pokračovat?
Unable to communicate with engine. Settings have NOT been saved.	Nelze komunikovat s motorem. Nastavení nejsou uloženy.
Communication Error	Chyba komunikace
Engine not stopped. Settings have NOT been saved.	Motor nezastavil. Nastavení nejsou uloženy.
Unable To Save Settings	Nelze uložit nastavení
Unable to communicate with engine. UPnP settings have not been updated	Nelze komunikovat s motorem. UPnP nastavení nebyly aktualizovány
Audio delay	Zpoždění zvuku
Enter a value in seconds (positive or negative) here to shift the audio relative to the video.\r\nUse this to resync the audio with the video, if they are out of sync after conversion.\r\nA positive value will delay the audio (i.e. video ahead of audio) and a negative value will advanced the audio (i.e. audio ahead of video).\r\nE.g. -1.5	Zadejte hodnotu v sekundách (kladné nebo záporné) posunout zvuk ve srovnání video.\r\nUse to nové synchronizace zvuku s videem, pokud jsou synchronizovány po conversion.\r\nA zde bude kladná hodnota zpoždění audio (tj video před audio) a záporná hodnota bude advanced audio (tj audio před video).\r\nE.g. -1,5
Media info	Informace o médiích
Click here to get media properties for selected files	Klikněte zde pro získání vlastností médií pro vybrané soubory
Save information	Uložení informací
Add information	Přidání informací o
Shows a preview of the custom filename and path	Zobrazí náhled na vlastní název souboru a cestu
Invalid Filename Pattern	Neplatný název souboru vzor
TVDB Series ID	TVDB řady ID
IMDB Series ID	IMDB řady ID
Original title	Původní název
Corrected title	Opravený titul
Enter the TVDB Series ID you want to use for downloading show information.\r\nIf the Original title box is empty, this will be applied to all shows selected by this conversion task.	Zadejte ID série TVDB, kterou chcete použít pro stažení Ukázat information.\r\nIf původní obsah pole název je prázdný, to budou použita pro všechny pořady zvolila tento úkol konverze.
Enter the IMDB Movie ID you want to use for downloading movie information.\r\nIf the Original title box is empty, this will be applied to all shows selected by this conversion task.	Zadejte ID IMDB film, který chcete použít pro stažení filmu information.\r\nIf původní obsah pole název je prázdný, to budou použita pro všechny pořady zvolila tento úkol konverze.
Internet Lookup Title and Metadata Correction	Internetové Vyhledávací název a oprava metadat
Click here to add another row to match and correct titles and series id.\r\nIf you want to use the same corrected title or series id for all shows converted by this conversion task,\r\nleave the original title blank on the first row and you should NOT add a second row.	Chcete-li přidat další řádek odpovídající a správné tituly a série id.\r\nIf chcete použít stejné opravený název nebo id číselné řady pro všechny pořady, které jsou převedeny do konverze úkol, \r\nleave původní název prázdné na první řádek a by není přidat druhý řádek.
Enter pattern to match show/series titles for correction (e.g. Simpson* will replace all titles that have a show title starting with Simpson)\r\nPrefix pattern with ~ to skip the match (e.g. *.*;~Simpson* will correct all show titles except those that start with Simpson)\r\nSeparate multiple patterns with ; (e.g. Simpson*;House*) or (e.g. Simpson*;NCIS*;~NCIS Miami*)\r\n\r\nNOTE: Leave this box empty if you want to apply the corrected title or series id to ALL files being processed by this conversion task.\r\nIf leaving blank, you cannot add a second row.\r\n\r\nYou can use a regular expression to match the title by starting with regex:	Zadejte vzorek Ukázat/seriálu tituly pro opravu (např. Simpson * nahradí všechny tituly, které mají název pořadu, počínaje Simpson) vzor \r\nPrefix s ~ Přeskočit na zápas (např. *. *; ~ Simpson * opraví všechny Výstavní tituly kromě těch, které začínají Simpson) \r\nSeparate více vzorků; (např. Simpson *;House*) nebo (např. Simpson *;NCIS*; ~ NCIS Miami *) \r\n\r\nNOTE: Toto pole ponechat prázdné, pokud chcete použít opravený název nebo id číselné řady pro všechny soubory, které jsou zpracovávány tento převod task.\r\nIf nechat prázdné, nelze přidat druhou row.\r\n\r\nYou lze použít regulární výraz odpovídající titul začínající regex:
Enter the new/corrected title you want to use for downloading additional information from the internet.\r\nIf the Original title box is empty, this will be applied to all shows selected by this conversion task.\r\n\r\nYou can use a regular expression to correct the title by starting with regex:	Zadejte nové/opraven název chcete použít pro stahování dalších informací z internet.\r\nIf původní obsah pole název je prázdný, to bude použito na všechny pořady zvolila tento převod task.\r\n\r\nYou může použít regulární výraz k nápravě titul začínající regex:
For each row, please enter the Original title to match the show name AND either a Corrected title or a TVDB/IMDB Series ID	Pro každý řádek, zadejte původní název, aby odpovídal názvu Ukázat a buď opraveno název nebo ID řady TVDB a IMDB
Please enter either a Corrected title or a TVDB/IMDB Series ID	Zadejte titul opraveno nebo TVDB/IMDB ID řady
Enable this if you want MCEBuddy to put the converted file in the source directory\r\nif the destination path is unavailable. (e.g. Network failure or mapping failure)	Povolit, pokud chcete MCEBuddy dát převedeném souboru v zdroj directory\r\nif cesta k cíli není k dispozici. (např. síťové chyby nebo selhání mapování)
Fallback to source path	Záloha pro zdrojovou cestu
Used to increase or decrease the volume of the\r\nrecording while converting.\r\n1 is normal, anything below will reduce it, anything\r\nhigher will increase it.	Lze zvýšit nebo snížit objem the\r\nrecording, zatímco converting.\r\n1 je normální, něco pod sníží, anything\r\nhigher se zvýší.
Archive folder	Složka archivu
Change the location of the archive folder.\r\nLeave empty to use the default 'MCEBuddyArchive' folder in the original directory.	Změna umístění archivu folder.\r\nLeave prázdné a použít výchozí složku 'MCEBuddyArchive' v původním adresáři.
Monitor subdirectories	Podadresáře monitoru
Check this box to also monitor all directories within the Monitor path	Zaškrtnutím tohoto políčka můžete také sledovat všechny adresáře v rámci sledování cesty
Click here to show MCEBuddy status	Klepnutím sem zobrazíte stav MCEBuddy
MCEBuddy service not connected	MCEBuddy služba není připojeno
MCEBuddy idle	MCEBuddy nečinné
conversions in progress	převody v průběhu
MCEBuddy stopped	MCEBuddy zastavil
Sync converted files	Synchronizovat převedených souborů
Check this option if you want MCEBuddy to keep the converted files in sync with the original files.\r\ni.e. When the original files are deleted by the user, the corresponding converted files are also deleted.\r\n\r\nNOTE: MCEBuddy only monitors original files in the monitor locations folders and ONLY while the engine is running.\r\nMCEBuddy will not be able to track user deleted files while the engine is stopped.	Tuto volbu zaškrtněte, pokud chcete MCEBuddy aby převedené soubory synchronizované s původním files.\r\ni.e. Když uživatel jsou odstraněny původní soubory, odpovídající převedené soubory jsou také deleted.\r\n\r\nNOTE: MCEBuddy pouze sleduje původní soubory ve složkách umístění monitoru a pouze když je motor running.\r\nMCEBuddy nebude schopen sledovat uživatele odstraněné soubory, zatímco po zastavení motoru.
Do you wish MCEBuddy to delete each converted file when the original file has been deleted?	Přejete MCEBuddy odstranit každého převedený soubor, když původní soubor byl odstraněn?
Confirm sync conversions?	Potvrzení převodů synchronizace?
Are you sure you DO NOT want to remove commercials from the converted video and only keep the EDL file?	Jste opravdu ne odstranit reklamy z převést video a jen udržet EDL souboru?
ShowAnalyzer is not responding. Please the reboot system or reinstall ShowAnalyzer.	ShowAnalyzer nereaguje. Prosím, restartování systému nebo znovu ShowAnalyzer.
ShowAnalyzer Not Responding	ShowAnalyzer neodpovídá
Make sure you press 'Start' after closing this window, otherwise Scheduling and Wake will not work.	Ujistěte se, že stiskněte tlačítko 'Start' po zavření tohoto okna, jinak nebude fungovat plánovací a probuzení.
Enabling Scheduling and Wake	Umožňuje plánování a probuzení
Passwords do not match	Hesla si neodpovídají.
Password error	Chyba hesla
Adding subtitles and chapters to file	Přidání titulků a kapitol do souboru
Send eMail if unable to download series information	Poslat eMail, pokud není schopen stáhnout informace o seriálu
Check this box if you want this conversion task to only process files from specific monitor locations.\r\nIf unchecked each conversion task will process files from all monitor locations (including new ones added later).	Toto políčko zaškrtněte, pokud chcete tento převod úkol zpracovat pouze soubory z konkrétní monitoru locations.\r\nIf unchecked každý úkol konverze bude zpracovávat soubory ze všech míst monitoru (včetně nových přidány později).
Select Monitor Locations	Vyberte umístění monitoru
Select atleast one Monitor Location name	Vyberte alespoň jeden název umístění monitoru
You have selected all the current Monitor Locations.\r\nDo you want this conversion task to automatically process any new Monitor Locations added in future?	Vybrali jste všechny současné Monitor Locations.\r\nDo konverze úkolu automaticky zpracovat žádné nové umístění monitoru přidané v budoucnosti?
New monitor locations	Nové umístění monitoru
Invalid selection	Neplatný výběr
Channel name match	Shoda názvů kanálů
Enter pattern to match the channel name for this task (e.g. ABC* will convert all files that recorded on a channel name starting with ABC)\r\nPrefix pattern with ~ to skip the match (e.g. *;~ABC* will process all channels except those that start with ABC)\r\nSeparate multiple patterns with ; (e.g. ABC*;TBS*) or (e.g. ABC*;Fox*;~Fox4*)\r\n\r\nYou can use regular expressions to match the pattern by starting with regex:	Zadejte vzor, aby odpovídal názvu kanálu pro tento úkol (např. ABC * převede všechny soubory nahrané na jméno kanálu s ABC) vzor \r\nPrefix s ~ Přeskočit na zápas (např. *; ~ ABC * zpracuje všechny kanály s výjimkou těch, které začínají s ABC) \r\nSeparate více vzorků; (např. ABC *;TBS*) nebo (např. ABC *;Fox*; ~ Fox4 *) \r\n\r\nYou lze použít regulární výrazy odpovídají vzoru pomocí regex:
Clear history	Vymazat historii
Click this button to clear the history of all converted files.\r\nThis is cause MCEBuddy to reconvert all files being monitored.	Klepněte na toto tlačítko Vymazat historii všech převedené files.\r\nThis je příčinou MCEBuddy převést všechny soubory, které jsou monitorovány.
Are you sure you want to clear the history of all conversions?\r\nThis will cause MCEBuddy to reconvert all files being monitored.	Opravdu chcete vymazat historii všech převodů? \r\nThis způsobí MCEBuddy převést všechny soubory, které jsou monitorovány.
Show history	Zobrazit historii
Click this button to show the history of all converted files.	Klepnutím na toto tlačítko zobrazíte historii všech převedených souborů.
History of Converted Files	Historie převedených souborů
Unable to communicate with engine.	Nelze komunikovat s motorem.
Extracting streams	Extrahování datových proudů
Fallback muxing streams	Náhradní multiplex proudy
Remuxing TiVO file	Remuxing TiVO soubor
Enter your 10 digit TiVO MAK key to convert and process TiVO recordings	Zadejte své desetimístným TiVO MAK identifikovat až k konvertita a zpracování nahrávek TiVO
Invalid TiVO MAK Key	Neplatný TiVO MAK klíč
The TiVO MAK key should be 10 digits	TiVO MAK klíč by měl být 10 číslic
Version mismatch. Please ensure that the MCEBuddy client and engine are running the same version.	Neshoda verzí. Přesvědčte se, zda že MCEBuddy klienta a motoru jsou se stejnou verzí.
Error retrieving Event Logs	Chyba při načítání protokolů událostí
Unable to get Event Log Entries from the MCEBuddy engine.	Nepodařilo se získat položky protokolu událostí z MCEBuddy motoru.
PAUSED: Check conversion schedule	POZASTAVENO: Plán převodu zkontrolujte
Logging	Protokolování
Folder Management	Správa složek
Processor Management	Správa procesoru
Expert Settings	Expertní nastavení
System Settings	Nastavení systému
Click here to change additional settings (for experts only)	Chcete-li změnit další nastavení (pouze pro experty)
Failed folder	Složku
Location of the folder that hold the original files for failed conversions.	Umístění složky, která drží původní soubory pro neúspěšné převody.
Move original file on failure	Přesunout soubor na selhání
Check this to move the original file to a separate folder if the conversion fails.	Toto zaškrtněte, aby původní soubor přesunout do samostatné složky, pokud převod nezdaří.
Check this to limit the number of logical processors that MCEBuddycan use.\r\nEach check box below corresponds to an available logical processor.	Zaškrtněte toto omezit počet logických procesorů, které MCEBuddycan use.\r\nEach políčko níže odpovídá dostupné logický procesor.
Each box represents logical processors from 1 to 16 respectively.\r\nChecking a box allows MCEBuddy to use that processor.	Každé pole představuje logické procesory od 1 do 16 respectively.\r\nChecking box umožňuje MCEBuddy používat tento procesor.
Each box represents logical processors from 17 to 32 respectively.\r\nChecking a box allows MCEBuddy to use that processor.	Každé pole představuje logické procesory od 17 do 32 respectively.\r\nChecking box umožňuje MCEBuddy používat tento procesor.
Select atleast one processor to use	Vyberte alespoň jeden procesor používat
Invalid Configuration	Neplatná konfigurace
Comskip path	Comskip cesta
If you want to use a custom version of Comkip (e.g. donator version)\r\nthen enter the path of the comskip installation here.\r\nLeave blank to use the default comskip that comes with MCEBuddy.	Pokud chcete použít vlastní verzi Comkip (např. verze donátora) \r\nthen zadejte cestu prázdné pro výchozí comskip, který je dodáván s MCEBuddy here.\r\nLeave instalace comskip.
Miscellaneous	Různé
Ignore copy protection	Ignorování ochrany proti kopírování
Check this to ignore the copy protection flag on video file while converting.\r\nNOTE: MCEBuddy cannot bypass encryption, this only helps if a file is incorrectly\r\ntagged as copy protected when it is NOT encrypted.	Toto zaškrtněte, aby ignorovat vlajky ochranu proti kopírování na video soubor při converting.\r\nNOTE: MCEBuddy nemůže obejít šifrování, to jen pomáhá, pokud je soubor incorrectly\r\ntagged jako disk, když to není zašifrována.
Use recycle bin	Používat koš
Check this to use the recycle bin when files are deleted by MCEBuddy	Toto zaškrtněte, aby použít koš, když soubory jsou odstraněny MCEBuddy
Poll period	Anketa období
This is how often MCEBuddy scans the Monitor Tasks Locations for new files.\r\nThe interval is specified in seconds.	To je, jak často prohledává MCEBuddy umístění monitoru úkoly pro nové files.\r\nThe interval je zadán v sekundách.
Server port	Port serveru
This is the TCP port MCEBuddy uses to communicate with the remote engine.\r\nWhen UPnP is enabled, MCEBuddy will automatically add this port to the Windows Firewall\r\nand UPnP gateway to allow access from the internet on this port.	Toto je port TCP, který MCEBuddy používá ke komunikaci s vzdálené engine.\r\nWhen UPnP je povolena, MCEBuddy automaticky přidá tento port k bráně Windows Firewall\r\nand UPnP povolit přístup z Internetu na tomto portu.
Hang period	Pověste období
Enter the number of seconds that MCEBuddy will wait for a response from the\r\nunderlying application before terminates the application as hung.\r\nEnter 0 to disable hang detection.	Zadejte počet sekund, po které MCEBuddy bude čekat na odezvu od the\r\nunderlying aplikace před ukončí aplikaci jako hung.\r\nEnter 0 zakázat rozpoznávání chyb.
Subtitle commercial cut sync	Podtitul komerční střih synchronizace
This parameter is used when the subtitles go progressively out of sync after each commercial segment is removed from the video.\r\nThis setting is used to bring the subtitles back into sync with the video.\r\nEach time the video commercial is cut out, the subtitles are time shifted by this amount (+ve or -ve in seconds).	Tento parametr se používá, když přejít postupně synchronizována po každý komerční segment je odebrán z video.\r\nThis nastavení se používá k titulky titulky zpět do synchronizace s video.\r\nEach době, kdy komerční video je jako stvořený, titulky jsou posunuty o tuto částku (+ ve nebo - ve v sekundách).
Invalid poll period	Neplatný průzkum období
Invalid server port	Port serveru neplatný
eMail Subject Customization	Napište předmět úpravy
Use this section to customize the subject of eMail sent by MCEBuddy on the various conversion events listed below.\r\nRefer to the documentation, custom commands for user defined variables.\r\ne.g. Show %showname% for file %originalfilename% conversion successful using task %taskname%\r\nNOTE: Not always will all the data be available in the custom commands.\r\nLeave blank to use default subject lines.	Použití této části upravit předmět e-mailu poslal MCEBuddy na různé konverzní události uvedeny below.\r\nRefer v dokumentaci, vlastní příkazy pro uživatelem definované variables.\r\ne.g. Zobrazit % showname % % převod souboru % originalfilename úspěšné použití úkol % taskname%\r\nNOTE: ne vždy všechna data budou k dispozici v prázdné použít výchozí předmět řádky vlastní commands.\r\nLeave.
Success	Úspěch
Failed	Se nezdařilo.
Cancelled	Zrušeno
Download fail	Stáhnout selhání
Limit processor utilization	Omezit využití procesoru
Check this to limit the number of logical processors that MCEBuddy can use.\r\nEach check box below corresponds to an available logical processor.	Zkontrolujte to omezit počet logických procesorů MCEBuddy může use.\r\nEach políčko níže odpovídá dostupné logický procesor.
Custom profile	Vlastní profil
If you have a custom profiles.conf file that you want to use instead of the\r\none that comes with MCEBuddy, enter the path to the file here.\r\n\r\nNOTE: MCEBuddy constantly updates profiles.conf to provide bug fixes,\r\nenhancements and performance improvements which you will miss out\r\non if you use this feature.	Pokud máte vlastní profiles.conf soubor, který chcete použít místo the\r\none, který je dodáván s MCEBuddy, zadejte cestu k souboru here.\r\n\r\nNOTE: MCEBuddy neustále profiles.conf aktualizace pro chybu opraví, zlepšení \r\nenhancements a výkonu, které out\r\non bude chybět, pokud tuto funkci použijete.
Invalid custom profiles.conf	Neplatné vlastní profiles.conf
Suspend on battery	Pozastavit na baterie
Suspend conversions when the computer switches to battery power	Pozastaví převody při přepnutí počítače na napájení z baterií
MCEBuddy added a video conversion to the queue	MCEBuddy přidal video konverze do fronty
Queue	Fronta
Refer to documentation on using custom commands in custom eMail subjects	Dokumentaci týkající se použití vlastních příkazů ve vlastních e-mailových subjektů
Could not copy information to Clipboard, please try again.	Nelze kopírovat informace do schránky, prosím zkuste znovu.
Error copying to Clipboard	Chyba při kopírování do schránky
Copy to clipboard	Kopírovat do schránky
Reconvert files	Převést soubory
Are you sure you want to reconvert the selected files?	Jste si jisti, že chcete převést vybrané soubory?
Select the files you want to reconvert and then click this button.\r\nIf the original files are still being monitored by MCEBuddy they will be queued for reconversion.	Vyberte soubory, které chcete převést zpět a pak klepněte na toto button.\r\nIf, původní soubory jsou stále sledován pomocí MCEBuddy bude být zařazen do fronty pro přeměnu.
Time taken to convert	Čas potřebný pro převod
Network authentication	Ověřování v síti
Click the button to enter the network shares credentials.\r\nThis authentication is used when files are added via the Add button on the main window\r\nor dragged and dropped from a network share into the conversion status box on the main window.	Klepněte na tlačítko pro ověření sítě akcie credentials.\r\nThis se používá, když soubory jsou přidány pomocí tlačítka Přidat na hlavní window\r\nor přetáhnout ze síťové sdílené položky do pole stav převodu v hlavním okně.
Skip reconversion	Převádění přeskočit zpět
Do not reconvert the video if a converted file already exists in the destination directory.	Převést video není, je-li převedený soubor již existuje v cílovém adresáři.
The expected filename for the converted video (not the original video filename) is compared with the filenames in the destination directory.\r\nIf the converted file exists, the file will not be reconverted and it will be assumed to be a successful conversion.\r\nThis is useful if the same show/episode is being recorded on multiple times and you don't want to reconvert them.\r\n\r\nNOTE: This option is ignored for videos that are added manually using the add button or dragging and dropping	Očekávaný název pro převedený video (nikoliv původní video souboru) je ve srovnání s názvy souborů v cílovém directory.\r\nIf převedený soubor existuje, soubor nebude převedeno zpět a bude se předpokládat, být úspěšný conversion.\r\nThis je užitečné, pokud stejnou show/epizoda se nahrává na vícekrát a nechcete znovu převést them.\r\n\r\nNOTE: Tato možnost je ignorována u videa, které jsou přidány ručně pomocí tlačítka Přidat nebo přetažení
If enabled, skip reconversion will also check the history file for past conversions.\r\nThe expected filename for the converted video (not the original video filename) is compared with the filenames in the history file.\r\nIf the to be converted filename (including path) matches any of the already converted filenames (including paths) in the history file,\r\nthe file will not be reconverted and it will be assumed to be a successful conversion.	Je-li povoleno, přeskočit přestavby zkontroluje soubor historie pro minulé conversions.\r\nThe očekává název pro převedený video (nikoliv původní video souboru) je ve srovnání s názvy souborů v historii file.\r\nIf být převedené název souboru (včetně cesty) odpovídá některému z již převedené názvy souborů (včetně cesty) v souboru historie, \r\nthe soubor nebude převedeno zpět a bude se předpokládá, že se převod úspěšný.
Adding file to the iTunes library	Přidání souboru do knihovny iTunes
Add to iTunes	Přidat do iTunes
Check this box to automatically add the converted files to the iTunes library.\r\nThis only works with iTunes supported files (e.g. MP4, M4V, MP3 etc)	Zkontrolujte, zda toto políčko automaticky přidat převedené soubory do iTunes library.\r\nThis pracuje pouze s iTunes podporované soubory (např. MP4, M4V, MP3 atd.)
Adding file to the WMP library	Přidání souboru do knihovny WMP
Library Management	Správa knihovny
Add to Windows Media Player	Přidat do programu Windows Media Player
Check this box to automatically add the converted files to the WMP library.	Zaškrtněte toto políčko, chcete-li automaticky přidat převedené soubory do knihovny WMP.
Renaming and Sorting	Přejmenování a třídění
Selection Filters	Výběr filtry
Audio and Video	Audio a Video
Subtitles and Chapters	Titulky a kapitol
Skip copying original files	Přeskočit kopírování původních souborů
CHECK THIS BOX AT YOUR OWN RISK.\r\nDO NOT CHECK THIS BOX UNLESS YOU KNOW WHAT YOU ARE DOING.\r\nCheck this box to skip making a backup of original file (copying) while converting.	Zkontrolujte tento BOX na svou vlastní RISK.\r\nDO není zkontrolovat tento BOX Pokud jste vědět, co se DOING.\r\nCheck toto políčko přeskočit vytvoření záložní kopie původního souboru (kopírování) při převodu.
CHECK THIS BOX AT YOUR OWN RISK.\r\nDO NOT CHECK THIS BOX UNLESS YOU KNOW WHAT YOU ARE DOING.\r\nCheck this box to skip making a backup of original file (copying) while converting.\r\nIf this is checked, the original file will not be preserved in case of an error.\r\nIt can also even lead to conversion failures or other unforeseen conversion issues.	ZKONTROLOVAT tento BOX na svou vlastní RISK.\r\nDO zaškrtněte toto políčko Pokud nevíte, co jste DOING.\r\nCheck přeskočit vytvoření záložní kopie původního souboru (kopírování) a converting.\r\nIf, to je zaškrtnuto, nebude zachován původní soubor v případě error.\r\nIt lze také i vést k chyby převodu nebo jiné nepředvídané konverzí problémy.
Are you sure you want to do this?	Jste si jisti, že chcete provést?
Media Information Management	Správa informací médií
Force show type	Síla typ prezentace
Set this to force treating the video recording as a Movie or TV Series.\r\nThis will change the way additional information (metadata) about the recording is downloaded from the internet.\r\nMovie - Treat the recording as movie\r\nSeries - Treat the recording as a TV Series\r\nSports - Treat the recording as a Sports show\r\nDefault - Use the default information available in the recording metadata to determine Movie or TV Series	Nastavte tuto vynutit zpracování videozáznamu jako film nebo TV Series.\r\nThis změní způsob, jakým další informace (metadata) o nahrávání je stažen z internet.\r\nMovie léčbu - Treat nahrávání jako movie\r\nSeries - Treat nahrávání jako TV Series\r\nSports - nahrávání jako sportovní show\r\nDefault - použití výchozí informace dostupné v nahrávání metadata k určení film či televizní seriál
Show type	Zobrazit typ
Select this to filter the type of recordings being converted.\r\n\r\nMovies - select this to convert if the show type is Movie.\r\nShows - select this to convert if the show type is NOT a Movie.\r\nSports - select this to convert if the show type is Sports.\r\n\r\nNOTE: Show type is read from the recording metadata.\r\nOnly some recordings support show type metadata such as WTV and\r\nrecordings with supporting metadata files (XML/ARG etc).	Vyberte to filtrovat typ nahrávek je converted.\r\n\r\nMovies - vyberte pro převod, pokud typ pořadu je Movie.\r\nShows - vyberte pro převod, pokud typ pořadu není Movie.\r\nSports - vyberte pro převod, pokud typ pořadu je Sports.\r\n\r\nNOTE: Show, typ je čten nahrávání metadata.\r\nOnly podporují některé nahrávky Ukázat typ metadat, jako například WTV and\r\nrecordings s podporou metadata soubory ()XML/ARG atd).
This box shows all the files in queue for conversion.\r\nDrag and drop files here or press the Add button to add files to the conversion queue	Toto políčko se zobrazí všechny soubory ve frontě pro conversion.\r\nDrag a přetažení souborů nebo klepnutím na tlačítko Přidat pro přidání souborů do fronty konverze
Conversion	Konverze
Files	Soubory
Click this button to open or close the Advanced Settings section	Toto tlačítko slouží k otevření nebo zavření oddílu Upřesnit nastavení
Running custom commands	Vlastní příkazy
Trimming video recording	Záznam videa oříznutí
Insert at top of queue	Vložit na začátku fronty
By default, new conversions are added to the bottom (end) of the conversion queue.\r\nIf this box is checked, any new conversions added by this task will be added to the\r\nbeginning (top) of the conversion queue.	Ve výchozím nové převody jsou přidány na konec (konec) konverze queue.\r\nIf toto políčko zaškrtnuto, nové převody, přidal do tohoto úkolu bude přidána do the\r\nbeginning (nahoře) fronty konverze.
Add subtitles and chapters	Přidat titulky a kapitol
Enable this option to add any extracted subtitles and chapters to the converted video.\r\nEach chapter marks the end of a commercial. This only works with supported formats (e.g. MKV, MP4).\r\n\r\nNOTE: Some players and older TV's don't support embedded subtitles and chapters.\r\nIf you're unable to playback the converted video's, try turning this option off.	Povolte tuto možnost, chcete-li přidat jakýkoliv citát titulky a kapitol na převedené video.\r\nEach kapitolu označí konec reklamy. To funguje pouze s podporovaných formátů (např. MKV, MP4).\r\n\r\nNOTE: někteří hráči a starší TV nepodporují vložené titulky a chapters.\r\nIf jste schopni přehrávání převedené video, vypněte tuto možnost.
Select best soundtrack	Vyberte nejlepší soundtrack
If the original video has multiple soundtracks, this option tells MCEBuddy to select the most appropriate and primary soundtrack.\r\nIf you want a specific language soundtrack, make sure you enter the language name or code in the Audio Language box.\r\nCheck this box if you're hearing the wrong soundtrack in your converted file.\r\n\r\nUncheck this box if you want MCEBuddy to retain all the soundtracks from the original video in the converted file when possible.\r\nNOTE:Some profiles do not support multiple soundtracks, in which case this setting has no effect.	Pokud původní video má více soundtracky, tato volba řekne MCEBuddy vybrat nejvhodnější a primární soundtrack.\r\nIf chcete konkrétní jazyk soundtrack, ujistěte se, že zadáte název jazyka nebo kódu v box.\r\nCheck Audio jazyk toto políčko, pokud slyšíte nesprávný soundtrack v převedené file.\r\n\r\nUncheck toto políčko, pokud chcete MCEBuddy zachovat všechny nahrávky z původního videa v převedeném souboru, pokud je to možné. \r\nNOTE: některé profily nepodporuje více soundtracky, v takovém případě nemá toto nastavení žádný účinek.
Enable remote access	Povolit vzdálený přístup
This creates an exception in the windows firewall for MCEBuddy application and the port.\r\nThis is required if you have windows firewall enabled and want to use UPnP, the remote client\r\nor access the engine using an IP address.\r\n\r\nNOTE: If you have a custom firewall, this may not work, you will need to manually create an\r\nexception for MCEBuddy service and the port.	Tím se vytvoří výjimku v bráně firewall systému windows pro aplikaci MCEBuddy a port.\r\nThis je vyžadován, je-li povolena brána windows firewall a chcete používat UPnP, přístup vzdálený client\r\nor motoru pomocí IP address.\r\n\r\nNOTE: Pokud máte vlastní firewall, to nemusí fungovat, budete muset ručně vytvořit an\r\nexception MCEBuddy služby a přístav.
Unable to communicate with engine. Firewall exception settings have not been updated.	Nelze komunikovat s motorem. Nastavení výjimek brány firewall nebyly aktualizovány.
Detect and optimize video quality	Rozpoznat a optimalizovat kvalitu videa
When enabled, MCEBuddy will optimize the video processing options by trying to detect the video source type.\r\nThis can improve the quality of the converted video significantly if correctly detected.\r\n\r\nNOTE: It does this by trying to detect the video source type (interlaced, progressive or telecine).\r\nIf it is able to detect the video source type, it will override the corresponding parameters in the profile.\r\nTurn this option off if you are facing issues with converted video quality or want to use the default profile parameters.	Pokud je povoleno, MCEBuddy bude optimalizovat možnosti zpracování videa a snaží se odhalit zdroj videosignálu type.\r\nThis může zlepšit kvalitu převedené video výrazně, pokud správně detected.\r\n\r\nNOTE: tím se snaží zjistit typ zdroje videa (prokládané, progresivní nebo telecine).\r\nIf je schopen detekovat typ zdroje videa, přepíší odpovídající parametry v profile.\r\nTurn tuto možnost vypnout, pokud jste se potýkají s problémy s kvalitou převedené videa nebo chcete použít výchozí profil parametry.
Are you sure you want to delete this task?	Jste si jisti, že chcete odstranit tuto úlohu?
Delete Task	Odstranit úkol
Enter the new task name	Zadejte název nové úlohy
Rename Task	Přejmenovat úkol
MCEBuddy PAUSED	MCEBuddy pozastaveno
idle	nečinné
PAUSED	POZASTAVENO
Frame rate	Frekvence snímků
Enable this to set a custom framerate (FPS) for the converted video.\r\nYou may need to set this while converting video formats (e.g. PAL to NTSC)\r\nor for devices which support only specific framerates.\r\n\r\nE.g.: 25\r\nE.g.: 30000/1001	Povolte tuto nastavit vlastní snímkovou rychlost (FPS) pro převedené video.\r\nYou může být nutné nastavit při konverzi video formátů (např. PAL na NTSC) \r\nor pro zařízení, která podporují pouze určité framerates.\r\n\r\nE.g.: 25\r\nE.g.: 30000/1001
Skip remuxing files	Přeskočit remuxing soubory
CHECK THIS BOX AT YOUR OWN RISK.\r\nDO NOT CHECK THIS BOX UNLESS YOU KNOW WHAT YOU ARE DOING.\r\nCheck this box to skip remuxing the original file to a TS file while converting.\r\nIf this is checked, some functions like subtitle extraction or comskip may not work.\r\nIt can also even lead to conversion failures or other unforeseen conversion issues.	ZKONTROLOVAT tento BOX na svou vlastní RISK.\r\nDO zaškrtněte toto políčko, pokud víš, co se DOING.\r\nCheck toto políčko přeskočit remuxing původní soubor TS souborů při converting.\r\nIf to je kontrolována, některé funkce, jako je extrakce titulků nebo comskip může není work.\r\nIt může také ještě vést k chyby převodu nebo jiné nepředvídané konverzí problémy.
CHECK THIS BOX AT YOUR OWN RISK.\r\nDO NOT CHECK THIS BOX UNLESS YOU KNOW WHAT YOU ARE DOING.\r\nCheck this box to skip remuxing the original file to a TS file while converting.	Zkontrolujte tento BOX na svou vlastní RISK.\r\nDO není zkontrolovat tento BOX Pokud jste vědět, co se DOING.\r\nCheck toto políčko přeskočit remuxing původní soubor do souboru TS při převodu.
Monitor converted videos	Sledovat převést videa
By default Monitor Locations will ignore files that have already been converted.\r\nCheck this box if you also want to monitor converted files in the Monitor Path.\r\nCAUTION: This can lead to an infinite conversion loop of converted files if not configured properly.\r\n\r\nThis can be useful when you are specifying the output directory of a conversion task\r\n(converted file) as the Monitor Path of a Monitor Location and linking the\r\nMonitor Location to another conversion task.	Ve výchozím nastavení sledování umístění bude ignorovat soubory, které již byly converted.\r\nCheck toto políčko Pokud chcete sledovat převedených souborů v Monitor Path.\r\nCAUTION: to může vést k nekonečné konverze smyčky převedených souborů, ne-li konfigurované properly.\r\n\r\nThis může být užitečné, když jsou určující výstupní adresář konverze task\r\n (převedený soubor) jako Monitor cestu Monitor umístění a propojení the\r\nMonitor Umístění na další konverze úkol.
CHECK THIS BOX AT YOUR OWN RISK.\r\nDO NOT CHECK THIS BOX UNLESS YOU KNOW WHAT YOU ARE DOING.\r\nBy default Monitor Locations will ignore files that have already been converted.\r\nCheck this box if you also want to monitor converted files in the Monitor Path.	Zkontrolujte tento BOX na svou vlastní RISK.\r\nDO není zkontrolovat tento BOX Pokud jste vědět, co se DOING.\r\nBy výchozí Monitor umístění bude ignorovat soubory, které již byly converted.\r\nCheck toto políčko, pokud chcete sledovat převedené soubory v cestě k monitoru.
Hardware encoding	Hardware kódování
Check this box to use hardware encoding when available to convert videos.\r\nThis can speed up the conversion significantly and reduce the CPU utilization\r\nbut it can result in slightly lower quality videos.\r\n\r\nUncheck this box if you're facing conversion or quality issues.	Toto políčko lze použít hardware kódování, pokud je k dispozici pro převod videos.\r\nThis může výrazně zrychlit konverze a snížit utilization\r\nbut CPU, které to může mít za následek mírně nižší kvalitu videos.\r\n\r\nUncheck toto políčko, pokud čelíte konverze nebo otázkách kvality.
Do not overwrite files	Nepřepisujte soubory
When this box is checked, the destination file will not be overwritten if it already exists.\r\nInstead a new file will be created with a unique number added to the end of the filename.	Když je toto políčko zaškrtnuto, cílový soubor nepřepíše, pokud to již exists.\r\nInstead nový soubor bude vytvořen s jedinečným číslem přidána na konec názvu souboru.
Re-monitor recorded videos	Opětovné sledování nahraného videa
By default, once a source file (Recorded video) has been converted,\r\nthe monitor history will track the filename and not queue the same files again.\r\n\r\nEnable this option to ignore the history and monitor all files and add them to\r\nthe conversion queue, even if they have already been converted.\r\n\r\nThis can be useful sometimes, if the recording software does not generate a\r\nunique filename for each episode/show. It is reccomended to use the\r\nDelete original file option in the Settings page when using this option to avoid\r\nan infinite conversion loop.	Ve výchozím nastavení, jakmile byla převedena zdrojový soubor (nahráno video), historie \r\nthe monitor bude sledovat filename a fronty stejné soubory again.\r\n\r\nEnable tuto možnost Ignorovat historie a sledovat všechny soubory a přidat je to\r\nthe frontu, i v případě, že již byly converted.\r\n\r\nThis může být užitečné někdy, je-li software pro záznam není generovat název a\r\nunique souboru pro každou epizodu nebo zobrazit. Doporučuje se použít the\r\nDelete původní soubor možnost ve stránce nastavení, při použití této možnosti smyčky nekonečné konverze avoid\r\nan.
Recommendation	Doporučení
To avoid an infinite conversion loop, it is recommended to setup your Monitor search pattern in a way such as to ensure that the converted files are not being monitored by this Monitor task.	Aby se zabránilo smyčky nekonečné konverzí, je doporučeno nastavit Monitor pátráním v jistém smyslu, jako aby se zajistilo, že převedené soubory nejsou monitorovány tento Monitor úkol.
CHECK THIS BOX AT YOUR OWN RISK.\r\nDO NOT CHECK THIS BOX UNLESS YOU KNOW WHAT YOU ARE DOING.\r\nBy default Monitor Locations will not remonitor recorded videos that have been processed.\r\nCheck this box if you want to remonitor and reconvert the recorded videos.	ZKONTROLOVAT tento BOX na svou vlastní RISK.\r\nDO nejsou zkontrolovat tento BOX Pokud jste vědět, co se DOING.\r\nBy výchozí umístění monitoru nesmí uskutečňovat nové sledování nahrané videa, které byly processed.\r\nCheck toto políčko, pokud chcete uskutečňovat nové sledování a zpětný převod nahraného videa.
To avoid an infinite conversion loop, it is recommended that you enable Delete original file option in the Settings page.	Aby se zabránilo smyčky nekonečné konverze, je doporučeno povolit odstranit původní soubor možnost ve stránce nastavení.
Prioritize air date matching	Priority vzduchu datum vyrovnání
MCEBuddy uses the episode name to match the series information\r\nwhile searching the internet. If that fails then it uses the original broadcast\r\nair date to match the metadata.\r\n\r\nCheck this box to use the original broadcast air date first and then the\r\nepisode name to match for the series information from the internet.\r\nThis can be useful in some cases when multiple seasons have the same\r\nepisode name. E.g. Americal Idol, Audition 1\r\n\r\nNOTE: Original broadcast air date is not always accurate set by the\r\nbroadcaster and sometimes the information on the internet is incorrect.\r\nUse this option only if the default option is not working for you.	MCEBuddy používá název epizody zápas série information\r\nwhile hledání na internetu. Pokud se to nepodaří používá původní datum broadcast\r\nair odpovídal metadata.\r\n\r\nCheck toto políčko použít původní datum vysílání vysílání první a pak the\r\nepisode název odpovídající informace série od internet.\r\nThis může být užitečná v některých případech, když více sezón mají název same\r\nepisode. Například Americal Idol, Audition 1\r\n\r\nNOTE: původní datum vysílání vzduchu není vždy přesné stanovené the\r\nbroadcaster a informace na internetu je někdy incorrect.\r\nUse tuto možnost pouze v případě, že výchozí možnost nefunguje pro vás.
Skip eMail body	Přeskočit text e-mailu
Check this option to use an empty body in the notification eMail.\r\nThis can be useful if you're using a SMS gateway for eMail notifications.	Zkontrolujte, zda tuto možnost použít prázdné tělo v eMail.\r\nThis oznámení může být užitečné v případě, že používáte SMS brány pro oznámení e-mailem.
Selection based on Digital Right Management (DRM) is available\r\nonly when Rename without converting (Rename and move only) option is selected.\r\n\r\nAll - Selects all files for processing, irrespective of copy protection status\r\nProtected - Only select files which are copy protected\r\nUnprotected - Only select files which do not have copy protection	Výběr založený na právo DRM (Správa digitálních) je available\r\nonly když přejmenovat bez převodu (přejmenování a přesunutí pouze) možnost selected.\r\n\r\nAll - vybere všechny soubory pro zpracování, bez ohledu na ochranu proti kopírování status\r\nProtected - jen vybrat soubory, které jsou kopie protected\r\nUnprotected - vybrat pouze soubory, které nemají žádnou ochranu proti kopírování
Download cover art	Stáhnout obálku
Enable this to download the cover art from the original video and internet if available.	Povolte tuto stáhnout obal alba z původního videa a Internetu, je-li k dispozici.
Are you sure you want to enter a Domain Name?\r\n\r\nUse this ONLY if you are using a Windows Domain Controller to manage your authentication.\r\nDo NOT use this if you are part of a Workgroup.\r\n\r\nIf you are unsure click NO.	Jste si jisti, chcete-li zadat název domény? \r\n\r\nUse toto pouze pokud používáte řadič domény systému Windows ke správě vašeho authentication.\r\nDo není použít, pokud jste součástí Workgroup.\r\n\r\nIf si jsou jisti, klepněte na tlačítko Ne.
Configuration Warning	Upozornění konfigurace
Creates a folder called 'MCEBuddyArchive' where the original file is located\r\nand moves the orginal file in this directory after a successful conversion.\r\n\r\nThis folder name and location be changed below.	Vytvoří složku s názvem 'MCEBuddyArchive', kde je původní soubor located\r\nand po úspěšné conversion.\r\n\r\nThis název složky a umístění změnit níže přesune původní soubor v tomto adresáři.
Monitoring	Monitorování
If you want to convert the EDL file into chapters, make sure you check the 'Add Subtitles and Chapters' option in Expert Settings.	Pokud chcete převést Seznam EDL souboru do kapitol, ujistěte se, že zaškrtnete volbu "Přidat titulky a kapitolami" v expertní nastavení.
EDL to Chapters	EDL kapitolám
