MCEBuddy does NOT use the currently logged in user to connect to network shares, it uses its own service account.  Be sure to specify the connection user information (MCEBuddy with a key icon)	MCEBuddy não usa o usuário conectado no momento para se conectar a compartilhamentos de rede, ele usa sua própria conta de serviço.  Certifique-se de especificar as informações de usuário de conexão (MCEBuddy com um ícone de chave)
Connection Reminder	Lembrete de conexão
Description	Descrição
Path	Caminho
is invalid	não é válido
Invalid Path	Caminho inválido
Please supply a task name	Por favor, forneça um nome de tarefa
No name supplied	Nenhum nome fornecido
Please enter the 3 digit language code of the Audio track or select <Default> or <Original>	Por favor, digite o código de idioma de 3 dígitos da faixa de áudio ou selecione <Default>ou <Original>
The 3 digit ISO code for the selected language\r\nMake sure this matches the language code for the audio track in the original recording.\r\nTo get the language code for the audio tracks in the original recorded file, add the file\r\nto the queue and right click on it. A pop up window will open showing the audio details\r\nwhich include the language codes for each audio track.	O dígito 3 código ISO para language\r\nMake selecionado-se combina com o código de idioma para a faixa de áudio no original recording.\r\nTo obter o código de idioma para as faixas de áudio no arquivo gravado original, adicionar o file\r\nto a fila e clique com o botão direito sobre ela. Uma janela pop-up será aberta mostrando o áudio details\r\nwhich incluem os códigos de idioma para cada faixa de áudio.
Invalid Language Code	Código de idioma inválido
No destination directory provided, converted file will be placed in original video directory	Nenhum diretório de destino fornecido, arquivo convertido será colocado no diretório vídeo original
A task name or section	Um nome de tarefa ou seção
already exists\n\rPlease use another name	já exists\n\rPlease usar outro nome
Duplicate Name	Nome duplicado
Engine	Motor
Tasks	Tarefas
Profile	Perfil
disposing	eliminação
Task name	Nome da tarefa
Give a unique name to this task	Dê um nome exclusivo para esta tarefa
Gives a short description for the selection conversion profile	Dá uma breve descrição para o perfil de conversão de seleção
Click to select destination folder	Clique para selecionar a pasta de destino
Destination	Destino
Select the directory where the converted file will be placed.\r\nLeave this blank to keep the converted file in the same directory as the original video.	Selecione o diretório onde o arquivo convertido será placed.\r\nLeave em branco para manter o arquivo convertido no mesmo diretório como o original do vídeo.
Max width	Largura máxima
This will limit the maximum width (in pixels) of the video for the converted file.\r\nTIP: Does not apply if the original file has a width smaller than this number.\r\nIf you want to keep your original video resolution move the slider all the way to the right.	Isso irá limitar a largura máxima (em pixels) do vídeo para o file.\r\nTIP convertido: não se aplica se o arquivo original tem uma largura menor do que esse number.\r\nIf você quer manter seu movimento de resolução do vídeo original o controle deslizante para a direita.
Quality	Qualidade
Ad remover	Removedor de anúncio
None	Nenhum
Get series details from Internet	Obter detalhes das séries de Internet
Download additional details about the movie or series from the internet	Baixar detalhes adicionais sobre o filme ou série de internet
File name match	Correspondência de nome de arquivo
Recording title match	Jogo de título de gravação
Cancel	Cancelar
OK	Razoável
Rename without converting	Renomear sem converter
Check this option to only rename and copy the original files to the destination folder.\r\nWhen checked, conversion, trimming, audio/video processing and commercial removal will not be available.\r\n\r\nNOTE: Other functions like matching filters, extracting subtitles, saving metadata and commercial detection (saving EDL file)\r\nwill still be available with this option checked.\r\nIf you want to move instead of copy, check the Skip copying original option in Expert Settings on this page or select\r\nDelete original file in the main settings page.	Verifique esta opção apenas renomear e copiar os arquivos originais para o destino folder.\r\nWhen marcada, conversão, limpeza, processamento de áudio/vídeo e remoção comercial não será available.\r\n\r\nNOTE: outras funções como filtros, extraindo legendas, salvar metadados e \r\nwill comercial deteção (salvar arquivo de EDI) ainda estar disponível com esta opção checked.\r\nIf você deseja mover-se em vez de copiar, verifique o Skip cópia original opção nas configurações do especialista nesse arquivo original página ou select\r\nDelete na página principal de configurações.
Rename and sort by video information	Renomear e classificar informações de vídeo
Renames the converted file and places it in a new directory based on the show/series information when available\r\n(e.g. ShowName\\ShowName-SXXEYY-EpisodeName-RecordDate)	Renomeia o arquivo convertido e o coloca em um novo diretório com base nas informações de mostrar da série quando available\r\n (por exemplo, ShowName\\ShowName-SXXEYY-EpisodeName-RecordDate)
Enter the username and password to access folders that are on a network drive or a different computer	Digite o nome de usuário e senha para acessar pastas que estão em uma unidade de rede ou um computador diferente
Organize by seasons	Organizar por temporadas
Organize folders by Showname and Season when available (Media Center/XBMC/Plex compatible naming convention)\r\n(e.g. Showname\\Season XX\\SXXEYY-Episode Name)	Organizar pastas por Showname e temporada quando disponível (Media Center/XBMC/Plex compatível Convenção de nomeclatura) \r\n (por exemplo, Showname\\Season XX\\SXXEYY-episódio nome)
Audio language	Idioma de áudio
Advanced Settings	Configurações avançadas
General Settings	Configurações gerais
Conversion Task	Tarefa de conversão
Password	Senha
Confirm Password	Confirmar senha
Domain / computer name	Domínio / nome do computador
<Optional> Enter if remote computer or network drive uses a Domain for authentication.\r\nDo NOT enter your workgroup here. Leave this blank if you're using a workgroup.	<Optional>Enter se o drive de rede ou computador remoto usa um domínio para authentication.\r\nDo não digite seu grupo de trabalho aqui. Deixe em branco se você estiver usando um grupo de trabalho.
User name	Nome de usuário
Enter the username to access the remote computer or network drive	Digite o nome do usuário para acessar a unidade de rede ou computador remota
Enter the password to access the remote computer or network drive	Digite a senha para acessar a unidade de rede ou computador remota
Network Connection User Credentials	Credenciais de usuário de conexão de rede
Password Mismatch	Incompatibilidade de senha
Passwords do not match, please reenter the passwords	As senhas não coincidem, por favor, digite novamente as senhas
Hour	Horas
Minute	Minuto
Wake	Esteira
Start	Início
Resume	Currículo
Pause	Pausa
Stop	Parar
Language	Língua
Pause conversion tasks	Tarefas de conversão de pausa
Resume conversion tasks	Tarefas de conversão de Resumo
Please enter a valid time	Por favor, introduza uma hora válida
Invalid Time	Hora inválida
Stop time is after Start time. Assuming the Stop time is during the next day, is that correct?	Tempo de parada é depois da hora de início. Supondo que o tempo de paragem é durante o dia seguinte, não é verdade?
Time Check	Seleção de tempo
Only select this option if MCEBuddy has been converting your files reliably for an acceptable period of time. Do you wish MCEBuddy to delete each original file once it has been converted?	Selecione esta opção apenas se MCEBuddy tem sido convertendo seus arquivos confiável por um período aceitável de tempo. Você deseja MCEBuddy para excluir cada arquivo original, uma vez que ele se converteu?
Confirm delete originals?	Confirmar exclusão originais?
MCEBuddy will monitor these directories for video files to convert automatically	MCEBuddy irá monitorar esses diretórios para arquivos de vídeo converter automaticamente
Conversion tasks	Tarefas de conversão
Delete original file	Excluir o arquivo original
Deletes the original recording after a successful conversion	Exclui a gravação original após uma conversão bem-sucedida
Min age before conversion (hours)	Idade min antes da conversão (horas)
Minimum hours to wait before converting each file after the file is added to the queue	Número mínimo de horas de espera antes de converter cada arquivo depois que o arquivo é adicionado à fila
Use this to change the language of the text on the screen	Use isto para mudar o idioma do texto na tela
Concurrent conversions	Conversões simultâneas
Number of simultaneous conversions MCEBuddy can start\r\nNOTE: You need large amounts of free disk space and processor time for more than 2 simultaneous conversions	Número de conversões simultâneas MCEBuddy pode start\r\nNOTE: você precisa de grandes quantidades de tempo de processador e espaço livre em disco para mais de 2 conversões simultâneas
Logging level	Nível de log
Error	Erro
Warning	Aviso
Information	Informações
Debug	Depuração
Log conversion jobs	Trabalhos de conversão de logs
Save a log file for each conversion in the \'logs\' directory where where MCEBuddy is installed\r\n(e.g. C:\\Program Files\\MCEBuddy2x\\logs)	Salvar um arquivo de log para cada conversão na \'logs\' diretório onde onde o MCEBuddy é installed\r\n (por exemplo, C:\\Program Files\\MCEBuddy2x\\logs)
Allow sleep	Permitir que o sono
If unchecked, it prevents the system from entering sleep while converting	Se estiver desmarcado, ele impede que o sistema de entrar em sono durante a conversão
Stop at	Parar em
No new conversions would be started after this time	Nenhuma conversão de novo teria começado após este tempo
minute	minuto
hour	horas
If checked MCEBuddy will wake the system from sleep\r\nat the specified Start time and enabled days of the week.	Se verificado MCEBuddy vai acordar o sistema de sleep\r\nat a hora de início especificada e habilitado para dias da semana.
Start at	Iniciar em
MCEBuddy will start new conversions between the Start and Stop time.\r\n\r\nThe Start time will be used for the enabled days of the week, whereas\r\nthe End time will be used either for the same day or\r\nfor the next day if the End time is after the Start time.	MCEBuddy iniciará novas conversões entre o início e parar de time.\r\n\r\nThe início tempo será usado para os habilitado dias da semana, whereas\r\nthe final tempo será usado para o mesmo dia or\r\nfor no dia seguinte se a hora final é após o horário de início.
Delete	Excluir
Add	Adicionar
Change	Mudança
Archive original file	Arquivo original
Domain name	Nome de domínio
Stops the monitor and conversion tasks and opens a page to configure MCEBuddy	Para as tarefas do monitor e conversão e abre uma página para configurar MCEBuddy
Creates a folder called \'MCEBuddyArchive\' where the original file is located\r\nand moves the orginal file in this directory after a successful conversion.\r\n\r\nThis folder name and location be changed in the System Settings page.	Cria uma pasta chamada \'MCEBuddyArchive\' onde está o arquivo original located\r\nand move o arquivo original neste diretório após um bem sucedido conversion.\r\n\r\nThis nome da pasta e o local ser alterado na página de configurações do sistema.
Debug - detailed logs, helps trace conversion problems\r\nInformation - logs basic information about conversion\r\nWarning - log potential issues or critical failures only\r\nError - log critical failures only	Debug - registros detalhados, ajuda a rastrear conversão problems\r\nInformation - registros de informações básicas sobre conversion\r\nWarning - registro possíveis problemas ou falhas críticas only\r\nError - falhas críticas no log apenas
Select the conversion profile associated with this task. The conversion profile represents the output format and quality for the converted file.\r\nHigher quality conversions take longer to convert. Reccomended Default: MP4 High Quality or MP4 Normal.\r\n\r\nTIP: Refer to the MCEBuddy Guide for advanced parameters to tweak conversion profiles or to create your own conversion profiles	Selecione o perfil de conversão associado a esta tarefa. O perfil de conversão representa o formato de saída e a qualidade a qualidade de file.\r\nHigher convertido conversões levam mais tempo para converter. Reccomended padrão: MP4 de alta qualidade ou MP4 Normal.\r\n\r\nTIP: consulte o guia de MCEBuddy para os parâmetros avançados para ajustar perfis de conversão ou criar seus próprios perfis de conversão
Select the program MCEBuddy will use to strip out any commercials while converting the video.\r\nSet to 'None' to leave the commercials in the converted video.\r\n\r\nTIP: To use ShowAnalyzer instead of Comskip, please download and install ShowAnalyzer.\r\nShow Analyzer version 1.0 and greater supported.	Selecione o programa MCEBuddy usará para retirar qualquer comerciais durante a conversão do video.\r\nSet como 'None' para deixar os comerciais em video.\r\n\r\nTIP o convertido: para usar ShowAnalyzer em vez de Comskip, por favor, baixe e instale o analisador ShowAnalyzer.\r\nShow versão 1.0 e maior suporte.
Used to change the video quality of the converted file, normal is 1.\r\nA higher number will improve quality but will take more time for conversion.\r\nA smaller number will reduce the quality but speed up the conversion.	Usado para alterar a qualidade do vídeo do arquivo convertido, normal é 1.\r\nA maior número irá melhorar a qualidade, mas levará mais tempo para conversion.\r\nA número menor irá reduzir a qualidade mas acelerar a conversão.
Enter pattern to match filenames for this task (e.g. *.wtv will convert all files ending with .wtv)\r\nPrefix pattern with ~ to skip the match (e.g. *.*;~*.wtv will process all files except those ending with .wtv)\r\nSeparate multiple patterns with ; (e.g. *.wtv;ncis*;~ncis miami*) will process all .wtv files and all files starting with ncis but not those starting with ncis miami\r\n\r\nYou can use regular expressions to match the pattern by starting with regex:	Digite padrão para coincidir com os nomes de arquivo para esta tarefa (por exemplo, o *.wtv irá converter todos os arquivos que terminam com padrão .wtv)\r\nPrefix com ~ para pular o jogo (por exemplo, *. *; ~*.wtv irá processar todos os arquivos, exceto aqueles terminando com .wtv)\r\nSeparate vários padrões com; (por exemplo, *.wtv; ncis *; ~ ncis miami *) irá processar todos os arquivos. wtv e todos os arquivos começando com ncis mas não aqueles que começam com ncis miami\r\n\r\nYou podem usar expressões regulares para corresponder ao padrão, iniciando com regex:
Enter pattern to match show/series titles for this task (e.g. Simpson* will convert all files that have a show title starting with Simpson)\r\nPrefix pattern with ~ to skip the match (e.g. *;~Simpson* will process all show titles except those that start with Simpson)\r\nSeparate multiple patterns with ; (e.g. Simpson*;House*) or (e.g. Simpson*;NCIS*;~NCIS Miami*)\r\n\r\nYou can use regular expressions to match the pattern by starting with regex:	Digite padrão para combinar títulos mostrar/série para esta tarefa (por exemplo, Simpson * irá converter todos os arquivos que possuem um título de show começando com Simpson) \r\nPrefix padrão com ~ para pular o jogo (por exemplo, *; ~ Simpson * processará todos mostrar títulos, exceto aqueles que começam com Simpson) \r\nSeparate múltiplos padrões com; (p. ex. Simpson *;House*) ou (p. ex. Simpson *;NCIS*; ~ NCIS Miami *) \r\n\r\nYou pode usar expressões regulares para corresponder ao padrão, iniciando com regex:
This can be used to override the default Audio Language when there are multiple audio languages in a recording.\r\nTo get the list of the Audio Languages in a recording, right click on the file in the queue and select MediaInfo.\r\n\r\n<Default> will try to keep all audio tracks if supported or let the encoder choose the default audio track\r\n<Original>, if available, will use the original [non-dubbed] recording language	Isso pode ser usado para substituir o padrão de idioma de áudio quando existem vários idiomas de áudio em um recording.\r\nTo obter a lista de idiomas de áudio na gravação, clique com o botão direito sobre o arquivo na fila e selecionar MediaInfo.\r\n\r\n <Default>tentar manter todas as faixas de áudio, se suportado ou deixar que o codificador escolher o padrão de áudio track\r\n <Original>, se disponível, usar a língua original de gravação [não dublada]
Enter '[video]' or leave blank to convert all video files\r\nEnter pattern to match filenames for this location (e.g. *.wtv will convert all files ending with .wtv)\r\nPrefix pattern with ~ to skip the match (e.g. *.*;~*.wtv will process all files except those ending with .wtv)\r\nSeparate multiple patterns with ; (e.g. *.wtv;ncis*;~ncis miami*) will process all .wtv files and all files starting with ncis but not those starting with ncis miami	Digite '[vídeo]' ou deixe em branco para converter todos os padrões de vídeo files\r\nEnter para coincidir com os nomes de arquivos para este local (por exemplo, o *.wtv irá converter todos os arquivos que terminam com padrão .wtv)\r\nprefix com ~ para ignorar a correspondência (p. ex. *. *; ~*.wtv irá processar todos os arquivos exceto os terminados com .wtv)\r\nseparate em vários padrões com; (por exemplo, *.wtv, ncis *; ~ ncis miami *) irá processar todos os arquivos de. wtv e começando com ncis, mas não aqueles que começam com ncis miami
MCEBuddy Settings	Configurações de MCEBuddy
MCEBuddy does NOT use the currently logged in user to connect to network shares, it uses its own service account.  Be sure to specify the connection user information [MCEBuddy with a key icon]	MCEBuddy não usa o usuário conectado no momento para se conectar a compartilhamentos de rede, ele usa sua própria conta de serviço.  Certifique-se de especificar as informações de usuário de conexão [MCEBuddy com um ícone de chave]
Please supply a source name	Por favor, forneça um nome de origem
Please supply a search path name	Por favor, forneça um nome de caminho de busca
A source name or section	Um nome de origem ou seção
already exists. Please use another name	já existe. Por favor, utilize outro nome
Monitor name	Nome do monitor
Give this a location a unique name	Dar a este um local de um nome exclusivo
Monitor path	Caminho de monitor
Select the directory that MCEBuddy will monitor in the background for new video files to convert automatically	Selecione o diretório que irá acompanhar de MCEBuddy em segundo plano para novos arquivos de vídeo converter automaticamente
Click to select the folder to monitor	Clique para selecionar a pasta para monitorar
Search pattern	Padrão de pesquisa
SourceForm	SourceForm
Monitor Location	Monitor local
Normal	Normal
MCEBuddy GUI: pipeProxy engine connection error	MCEBuddy GUI: erro de conexão do mecanismo de pipeProxy
MCEBuddy GUI: Unable to create pipe to MCEBuddy service	MCEBuddy GUI: Não é possível criar pipe para serviço de MCEBuddy
The MCEBuddy service is unavailable. Please start from Windows control panel or check engine connection.	O serviço de MCEBuddy está disponível. Por favor, começar a partir do painel de controle do Windows ou verifique a conexão do motor.
Announcement	Anúncio
New version 	Nova versão 
available	disponível
New BETA version 	Nova versão BETA 
Click here to download new version of MCEBuddy	Clique aqui para baixar a nova versão do MCEBuddy
Click here to open link	Clique aqui para abrir o link
Idle	Inativo
Closing	Fechar
MCEBuddy GUI: Unable to update tasks	MCEBuddy GUI: Não é possível atualizar tarefas
MCEBuddy GUI: Unable to start MCEBuddy service	MCEBuddy GUI: Não é possível iniciar o serviço de MCEBuddy
MCEBuddy GUI: Unable to stop MCEBuddy service	MCEBuddy GUI: Não é possível parar o serviço de MCEBuddy
MCEBuddy GUI: Unable to cancel job	MCEBuddy GUI: Não é possível cancelar trabalho
Warning: Networked files will be accessed using the logon credentials of the MCEBuddy Service, not the currently logged on user. You can manually specify the network credentials from the Settings -> Expert Settings page in MCEBuddy.	Aviso: Arquivos em rede serão acessados usando as credenciais de logon do MCEBuddy Service, não o usuário conectado no momento. Você pode especificar manualmente as credenciais de rede das configurações do-> a página de configurações de especialista em MCEBuddy.
Credential Warning	Aviso de credencial
Status	Estatuto
MCEBuddy GUI: Unable to add job	MCEBuddy GUI: Não é possível adicionar tarefa
MCEBuddy GUI: Unable to get pipe active status	MCEBuddy GUI: Não é possível obter o status de ativo de tubos
The conversions must be stopped to change settings. Stop the conversions?	As conversões devem ser interrompidas para alterar as configurações. Parar as conversões?
Stop Engine	Desligue o motor
MCEBuddy GUI: Unable to stop MCEBuddy service from settings click	MCEBuddy GUI: Não é possível parar o serviço de MCEBuddy de configurações clique
MCEBuddy GUI: Unable to rescan files	MCEBuddy GUI: Não é possível examinar novamente arquivos
MCEBuddy GUI: Unable to open link	MCEBuddy GUI: Não é possível abrir a ligação
Close	Fechar
Close this window, MCEBuddy will keep running in the background	Fechar esta janela, MCEBuddy continuarão a ser executados em segundo plano
If you like MCEBuddy, please click here to Donate - THANKS	Se você gosta de MCEBuddy, por favor clique aqui para doar - obrigado
Click here to like MCEBuddy on facebook	Clique aqui para como MCEBuddy no facebook
Click here to open MCEBuddy website	Clique aqui para abrir o site MCEBuddy
Rescan	Nova pesquisa
Forces the MCEBuddy to recheck the Monitor locations for new video files to convert	Forças MCEBuddy para verificar novamente as localizações de Monitor para novos arquivos de vídeo converter
Monitor locations	Locais de monitor
Settings	Configurações
Select the file(s) in the queue to delete	Selecionar os arquivos na fila a excluir
Manually add video file(s) to the queue to convert	Manualmente adicionar arquivos de vídeo para a fila para converter
Start the MCEBuddy monitor and conversion tasks	Iniciar as tarefas de monitor e conversão de MCEBuddy
Stop the MCEBuddy monitor and conversion tasks	Parar as tarefas de monitor e conversão de MCEBuddy
There is a new version!	Há uma nova versão!
High	Alta
Low	Baixo
Priority	Prioridade
High priority - convert faster but may make other running applications unresponsive\r\nLow priority - convert in the background but reduced interference with other running applications	Alta prioridade - converter mais rápido, mas pode criar outros aplicativos em execução prioridade unresponsive\r\nLow - converter no fundo mas reduzida interferência com outros aplicativos em execução
A task is a conversion template that contains a conversion profile and various other conversion parameters.\r\nEach file added to the queue will be processed and converted by each of these tasks.\r\nRefer to the MCEBuddy Guide for more details on how tasks work.	Uma tarefa é um modelo de conversão que contém um perfil de conversão e vários outros parameters.\r\nEach de conversão arquivo adicionado à fila será processado e convertido por cada um destes tasks.\r\nRefer o guia MCEBuddy para obter mais detalhes sobre como trabalham tarefas.
Getting started	Guia de introdução
Click here for MCEBuddy guide	Clique aqui para MCEBuddy guia
Logs	Registos
Click to open log folder	Clique para abrir a pasta de log
MCEBuddy Status	MCEBuddy Status
add	Adicionar
delete	Excluir
paypal-donate	PayPal-doar
stop	parar
OUTPUT: ConsoleOuput received NULL data	SAÍDA: ConsoleOuput recebido dados NULL
hours	horas
minutes	minutos
second	segundo
seconds	segundos
Starting	Começando
Comskip advertisement scan - Pass 1	Varredura de anúncio Comskip - passar 1
Comskip advertisement scan - Pass 2	Varredura de anúncio Comskip - passar 2
Cutting commercials from video	Comerciais de corte de vídeo
Cutting commercials from video - segment 	Segmentação de anúncios publicitários de corte de video- 
Merging commercial free segments into new video	Mesclando comerciais segmentos grátis em novo vídeo
Moving converted file to destination	Mover o arquivo convertido para o destino
Checking for disk space	Verificação de espaço em disco
Getting show information and banner from Internet sources	Obter banner e mostrar informações de fontes da Internet
Copying source file to working directory	Copiar o arquivo de origem para o diretório de trabalho
Remuxing recording	Gravação de remuxing
ShowAnalyzer advertisement scan	Verificação do anúncio de ShowAnalyzer
Comskip advertisement scan	Verificação do anúncio de Comskip
Analyzing video information	Analisando informações de vídeo
Converting	Convertendo
Removing commercials	Remoção de anúncios publicitários
Writing show information	Gravando informações de Visualizar
Renaming file using show information	Renomeando arquivos usando Visualizar informações
Success - All done!	Sucesso - tudo feito!
Muxing streams	Fluxos de muxing
Fallback remux	Remux fallback
Correcting audio delay	Que rectifica o atraso de áudio apenas
Converting video file - Pass 1	Converter arquivo de vídeo - passar 1
Converting video file - Pass 2	Converter arquivo de vídeo - passar 2
Converting video file	Converter arquivo de vídeo
Audio Track	Faixa de áudio
Impaired	Deficientes auditivos
Channels	Canais
Codec	Codec
Video	Vídeo
Duration	Duração
Height	Altura
Width	Largura
Audio	Áudio
Name	Nome
Subtitle	Legendas
Volume	Volume
Enable custom file renaming	Ativar a renomeação de arquivo personalizadas
Enable this to enter a custom pattern to rename converted files and folders. Enter the custom pattern in the box below.\r\n\r\nExample:\r\nTVShows\%showname%\Season %season%\%showname% - S%season%##E%episode%## - %episodename% - %airyear%_%airmonth%_%airday%\r\n\r\nWill produce:\r\nTVShows\CSI\Season 1\CSI - S01E02 - Best of times - 2012_01_06.<ext>\r\n\r\nExample:\r\nRecording\%ismovie%<Movie\%showname%,TVShows\%showname%\Season %season%\%showname% - S%season%##E%episode%##>-Converted\r\n\r\nWill produce (for a movie)\r\n    Recording\Movies\Star Wars-Converted.<ext>\r\nOR (for non movies)\r\n    Recording\TVShows\CSI\Season 1\CSI - S01E02-Converted.<ext>\r\n\r\nRefer to the MCEBuddy advanced documentation for a list of all the pattern commands.	Ativar este entrar um padrão personalizado para renomear pastas e arquivos convertidos. Digite o padrão personalizado na caixa below.\r\n\r\nExample:\r\nTVShows\%showname%\Season %season%\%showname% - S % temporada % ##E % episódio % #-% episodename % - %airyear%_%airmonth%_%airday%\r\n\r\nWill produto: \r\nTVShows\CSI\Season 1\CSI - S01E02 - melhor dos tempos - 2012_01_06.<ext>\r\n\r\nExample:\r\nRecording\%ismovie% < Movie\%showname%,TVShows\%showname%\Season %season%\%showname% - S%season%##E%episode%##>-Converted\r\n\r\nWill produtos (para um filme) \r\n Recording\Movies\Star Wars-convertido. <ext>1\CSI de \r\n Recording\TVShows\CSI\Season de \r\nOR (para filmes não) - S01E02-convertido.<ext>\r\n\r\nRefer para o MCEBuddy avançado de documentação para obter uma lista de todos os comandos padrão.
ShowAnalyzer not found.\nPlease download and install ShowAnalyzer.	ShowAnalyzer não foi encontrado. \ nPor favor Baixe e instale o ShowAnalyzer.
ShowAnalyzer Missing	ShowAnalyzer ausente
Invalid language code, reverting to <Default> language	Código de idioma inválido, revertendo a linguagem <Default>
Cut start	Cortar o início
Cut end	Corte a extremidade
This specifies the number of seconds to cut from the start of the recording (BEFORE removing the ads)	Isso especifica o número de segundos para cortar desde o início da gravação (antes de remover os anúncios)
This specifies the number of seconds to cut from the end of the recording (BEFORE removing the ads)	Isso especifica o número de segundos para cortar a partir do final da gravação (antes de remover os anúncios)
Send an eMail after each conversion.	Envie um eMail após cada conversão.
Send eMail	Enviar E-mail
SMTP Server Name	Nome do servidor SMTP
Enter the outgoing eMail (SMTP) server address here\r\ne.g. smtp.gmail.com	Insira a saída here\r\ne.g de endereço de servidor de E-mail (SMTP). SMTP.gmail.com
Port	Porto
Enter the SMTP server port	Digite a porta do servidor SMTP
Use SSL	Usar SSL
Check this if you SMTP server uses SSL	Marque esta opção se você SMTP server usa SSL
e-Mail Settings	Configurações de e-Mail
From <e-Mail>	De <e-Mail>
Enter the senders (From) eMail address here	Insira os remetentes (de) endereço de E-mail aqui
To <e-Mails>	Para <e-Mails>
Enter the recipients (To) eMail address here.\r\nSeparate multiple recipients with a semicolon (;)	Insira os destinatários (A) here.\r\nSeparate endereço de E-mail de vários destinatários com um ponto e vírgula (;)
Send eMail on successful conversion	Enviar E-mail sobre conversão bem-sucedida
Send eMail on failed conversion	Enviar E-mail sobre conversão falhou
Send eMail on cancelled conversion	Enviar E-mail sobre conversão cancelado
Send eMail on adding a conversion to the queue	Enviar E-mail sobre a adição de uma conversão para a fila
Please enter a valid server address	Por favor insira um endereço de servidor válido
Invalid SMTP Server	Servidor de SMTP inválido
Please enter a valid server port	Por favor, digite uma porta de servidor válido
Invalid SMTP Port	Porta de SMTP inválido
Please enter a valid From eMail address	Por favor, digite um válido endereço de correio electrónico
Invalid eMail Address	Endereço de E-mail inválido
Please enter valid To eMail addresses	Por favor, digite válido para endereços de E-mail
Username	Nome de usuário
<Optional> Enter the username for the eMail server authentication	<Optional>Digite o usußrio do servidor para a autenticação de servidor de E-mail
<Optional> Enter the password for the eMail server authentication	<Optional>Enter a senha para a autenticação de servidor de E-mail
MCEBuddy unable to download series information	MCEBuddy não é possível transferir informações de série
MCEBuddy successfully converted a video	MCEBuddy converteu um vídeo
Source Video	Vídeo de origem
Converted Video	Vídeo convertido
Converted At	De conversão
MCEBuddy failed to converted a video	MCEBuddy falha ao converter um vídeo
Failed At	Falha no
MCEBuddy cancelled a video conversion	MCEBuddy cancelado uma conversão de vídeo
Cancelled At	Cancelado
Working	Trabalhando
Test	Teste
Testing	Teste
Click this button to test the eMail server settings	Clique neste botão para testar as configurações de servidor de E-mail
MCEBuddy will send an eMail to test the server settings.\r\nThis can take upto 60 seconds.\r\nMCEBuddy may be unresponsive during this period.	MCEBuddy irá enviar um E-mail para settings.\r\nThis o servidor de teste pode levar até 60 seconds.\r\nMCEBuddy pode ser reparado durante este período.
Test eMail	Teste de eMail
MCEBuddy Test eMail	MCEBuddy teste de eMail
MCEBuddy - Have a great day!	MCEBuddy - tenha um ótimo dia!
Send eMail test successful	Enviar teste de E-mail bem sucedido
Send eMail test failed! Please check your settings and internet connectivity	Envie teste de E-mail falhado! Por favor, verifique suas configurações e conectividade com a internet
Test eMail Success	Teste de eMail sucesso
Test eMail Failed	E-mail de teste falhou
Send eMail on start of conversion	Enviar E-mail no início da conversão
MCEBuddy started a video conversion	MCEBuddy começou uma conversão de vídeo
Conversion Started At	Conversão iniciada às
Yes (Comskip)	Sim (Comskip)
Yes (ShowAnalyzer)	Sim (ShowAnalyzer)
Atleast one Conversion Task must be enabled	Pelo menos que uma tarefa de conversão deve estar habilitada
Disable	Desativar
Enable	Ativar
Rename	Renomear
Move	Mover-se
Up	Up
Down	Para baixo
Slow Remuxing	Remuxing lento
Extracting closed captions	Extraindo legendas
Validating closed captions	Validando closed caption
Extracting subtitles	Extraindo legendas
Trimming closed captions	Aparamento fechado legendas
Extract subtitles and closed captions	Extrato de legendas e legendas
Field	Campo
Channel	Canal
Enable this to extract Closed Captions, Subtitles and Teletext from\r\nWTV, DVR-MS, TS, MP4, MKV and other supported files.\r\n\r\nIt is saved as a Subtitle (SRT) file.	Habilitar isso extrair Closed Captions, legendas e teletexto from\r\nWTV, DVR-MS, TS, MP4, MKV e outros com suporte files.\r\n\r\nIt é salvo como um arquivo de legendas (SRT).
Enable this to set advanced options for Closed Captions extraction\r\nField - 1 or 2\r\nChannel - 1 or 2\r\n\r\nDefault: Field 1, Channel 1	Habilitar esta opção para definir opções avançadas para Closed Caption extraction\r\nField - 1 ou 2\r\nChannel - 1 ou 2\r\n\r\nDefault: campo 1, canal 1
Subtitle offset	Deslocamento de legendas
Enter the number of seconds (+ve / -ve) to adjust the subtitles sync with video	Insira o número de segundos (+ ve / - ve) para ajustar a sincronização de legendas com o vídeo
Re-ReMuxing due to audio error	Re-ReMuxing devido a erro de áudio
Save the poster and show information (metadata) in a MC/XBMC compatible NFO file (XML format)	Salve o cartaz e mostrar informações (metadados) em um arquivo de NFO compatível MC/XBMC (formato XML)
Check this box to save the show information (metadata) in the converted file.\r\nThis only works for files that support metadata tags like MP4, MKV, WTV etc.\r\n\r\nNOTE: Uncheck this box if you're facing issues with some devices such as older TV's which have problem reading metadata.	Marque esta caixa para salvar as show de informações (metadados) no file.\r\nThis convertido só funciona para arquivos que suporte a tags de metadados como MP4, MKV, WTV etc.\r\n\r\nNOTE: desmarque esta caixa se você está enfrentando problemas com alguns dispositivos, como TVs mais antigas que têm leitura problema metadados.
Atleast one day of the week must be enabled	Pelo menos um dia da semana deve estar habilitado
Invalid Days of Week	Inválido dias da semana
Invalid day of week found in configuration file	Dia inválido da semana encontrado no arquivo de configuração
Scheduling	Agendamento
Remuxing to	Remuxing para
Part	Parte
Rest your mouse on any button, box or item to get Instant Help on it.\n\nFor more information on how to use, troubleshoot or get support for MCEBuddy click on the <Getting Started> link on the top right corner.\n\nDonations are always welcome :) Enjoy!\n\n  - Ramit, Derek & Goose	Resto seu mouse sobre qualquer botão, a caixa ou o item para obter ajuda imediata em it.\n\nFor obter mais informações sobre como usar, solucionar problemas ou obter suporte para MCEBuddy clique no link < Começando > sobre a corner.\n\nDonations direita superior são sempre bem-vindos :) Aproveite! \n\n - Caio, Derek & ganso
Welcome to MCEBuddy	Bem-vindo ao MCEBuddy
Multichannel audio	Áudio multicanal
Check to allow multi-channel audio if the source video supports it.\r\nBy default the audio is limited to 2 channels (stereo).	Seleção para permitir multi-canal de áudio se a fonte de vídeo suporta o padrão de it.\r\nBy o áudio é limitada a 2 canais (estéreo).
Dynamic Range Compression (DRC)\r\nWhen the source is an AC3 audio, enabling DRC will\r\nreduce the difference between the loud and the soft\r\nsounds making the audio track more even.\r\nIf you have a multi-channel audio recording and you\r\nfeel the volume is too soft, checking this box might help.	Dynamic Range compressão (RDC) \r\nWhen a fonte é um áudio AC3, permitindo que a RDC will\r\nreduce a diferença entre o alto e o soft\r\nsounds fazendo a faixa de áudio mais even.\r\nIf que você tem uma gravação de áudio multi-canal e you\r\nfeel que o volume é muito mole, pode ajudar a esta caixa de verificação.
FPS	FPS
Logfile age (days)	Logfile idade (em dias)
Maximum number of days to keep the logfiles before deleting them.\r\nSet to 0 to keep the logs forever.	Número máximo de dias para manter os arquivos de log antes de excluir o them.\r\nSet como 0 para manter os logs para sempre.
DVRMS Remuxing	DVRMS Remuxing
Fast Remuxing	Remuxing rápido
Byte stream remuxing	Byte stream remuxing
Disable cropping	Desabilitar o corte
Check this to disable cropping the video automatically during conversion.\r\nCropping is used to remove the "black bars" in the video (top, bottom, left or right).\r\nUse this option if the video picture is getting cut on any side or if the final picture is looking stretched or distorted.	Verifique isso desativar cortar o vídeo automaticamente durante conversion.\r\nCropping é usado para remover as "barras pretas" em vídeo (superior, inferior, esquerda ou right).\r\nUse esta opção se a imagem de vídeo está ficando cortada em qualquer lado, ou se a imagem final é olhar esticado ou distorcida.
Only detect Ads	Somente detectar anúncios
Check this if you want MCEBuddy to detect the ads (commercials) but NOT cut them from the video.\r\nWhen this option is enabled, MCEBuddy will create an EDL file along with the converted file that specifies the locations of ads in the converted video.\r\nAlso, for MP4, M4V and MKV files MCEBuddy will create Chapters to mark the end of commercials.	Verificar isso, se você quer MCEBuddy para detectar os anúncios (publicidade) mas não cortá-los de video.\r\nWhen que esta opção é habilitada, MCEBuddy irá criar um arquivo EDL junto com o arquivo convertido que especifica a localização dos anúncios no video.\r\nAlso convertido, para MP4, M4V e arquivos MKV MCEBuddy irão criar capítulos para marcar o fim dos comerciais.
Download information	Download de informações
Correction	Correção
Click here to correct the Show title and force use of a specific TVDB series id or IMDB movie id\r\nto lookup additional metadata from the internet.	Clique aqui para corrigir o título do Show e forçar o uso de um id específico da série TVDB ou id\r\nto de filme IMDB pesquisa metadados adicional da internet.
Check this to download additional information from the internet about the show like a banner file, episode, season etc	Marque esta opção para fazer o download de informações adicionais da internet sobre o show como um arquivo de banner, episódio, temporada etc
Profile Error	Erro de perfil
Cannot find selected profile in profiles.conf	Não é possível localizar o perfil selecionado no profiles.conf
Invalid Profile	Perfil inválido
Please select a valid profile	Por favor, selecione um perfil válido
The MCEBuddy Engine has crashed. Please send mcebuddy.log to the developers	O mecanismo de MCEBuddy deixou de funcionar. Por favor enviar mcebuddy.log para os desenvolvedores
Comskip INI	Comskip INI
Select the custom Comskip INI file to use for this conversion task\r\nLeave this blank to use the default Comskip INI file for advertisement removal	Selecione o arquivo de Comskip INI personalizado para utilizar para esta conversão task\r\nLeave este espaço em branco para usar o padrão de arquivo INI Comskip para remoção de propaganda
Click to select custom Comskip INI file	Clique para selecionar o arquivo INI Comskip personalizado
Select the folder for working with temporary files. Make sure there is enough empty space on the drive.\r\nLeave this blank to use the default temp folder in the installation folder.	Selecione a pasta para trabalhar com arquivos temporários. Certificar-se de que há suficiente vazio espaço sobre o drive.\r\nLeave este espaço em branco para usar a pasta temp na pasta de instalação.
Select the folder for working with temporary files. Make sure there is enough empty space on the drive.\r\nThis overrides the temp folder specified in the Settings -> Expert Settings page.	Selecione a pasta para trabalhar com arquivos temporários. Verifique se há que bastante espaço vazio no drive.\r\nThis substitui a pasta temp especificada nas configurações do-> página Configurações de especialista.
Click to select temp working folder	Clique para selecionar a pasta de trabalho temporário
Temp folder	Pasta Temp
Space check	Espaço em disco
When enabled MCEBuddy will check for enough free space for the conversion (destination and temp).\r\nUncheck this if you have are having trouble with network drives or have extraordinarily large video files.	Quando MCEBuddy habilitado irá verificar se há espaço livre suficiente para a conversão (destino e temp).\r\nUncheck isso, se você tiver estão tendo problemas com drives de rede ou tem extraordinariamente grandes arquivos de vídeo.
MCEBuddy Windows Event Logs	Logs de eventos do Windows MCEBuddy
Events	Eventos
Click here to open the MCEBuddy Windows Event Logs	Clique aqui para abrir os Logs de eventos do Windows MCEBuddy
Enable UPnP	Habilitar UPnP
Check this to enable UPnP. This allows access to MCEBuddy engine from outside the network.\r\nThis needs to be checked if you're using a mobile/standalone MCEBuddy client to access MCEBuddy.	Verificar isso para habilitar UPnP. Isso permite que o acesso ao motor de MCEBuddy de fora o network.\r\nThis precisa ser verificado se você estiver usando um cliente de MCEBuddy móvel/independente para acessar MCEBuddy.
Click here to connect to another MCEBuddy engine	Clique aqui para se conectar a outro mecanismo de MCEBuddy
MCEBuddy Remote Engine Connection	Ligação de motor de MCEBuddy remoto
Engine Name	Nome do motor
Engine Port	Motor de porta
Enter the Name or IP Address of the MCEBuddy engine you want to connect to	Digite o nome ou endereço IP do motor MCEBuddy que você deseja se conectar
Enter the TCP Port number of the MCEBuddy Engine you want to connect to	Digite o número da porta TCP do motor MCEBuddy você deseja se conectar
Enter the TCP Port number of the MCEBuddy Engine you want to connect to (1 to 63355)	Digite o número da porta TCP do motor MCEBuddy você deseja se conectar (1 para 63355)
Invalid Name/Port	Nome inválido/Porto
Please enter a valid Engine Name and Engine Port Number	Por favor insira um nome do mecanismo válido e número de porta do motor
Error Stopping Engine	Erro parar o motor
Unable to stop MCEBuddy engine, settings may not be saved. Do you want to continue?	Incapaz de parar o motor de MCEBuddy, as configurações não podem ser salvos. Você deseja continuar?
Unable to communicate with engine. Settings have NOT been saved.	Incapaz de se comunicar com o motor. Configurações não foram salvas.
Communication Error	Erro de comunicação
Engine not stopped. Settings have NOT been saved.	Motor não parado. Configurações não foram salvas.
Unable To Save Settings	Não é possível salvar as configurações
Unable to communicate with engine. UPnP settings have not been updated	Incapaz de se comunicar com o motor. UPnP configurações não foram atualizadas
Audio delay	Atraso de áudio
Enter a value in seconds (positive or negative) here to shift the audio relative to the video.\r\nUse this to resync the audio with the video, if they are out of sync after conversion.\r\nA positive value will delay the audio (i.e. video ahead of audio) and a negative value will advanced the audio (i.e. audio ahead of video).\r\nE.g. -1.5	Insira um valor em segundos (positivos ou negativos) aqui para transferir o áudio em relação a video.\r\nUse isso para voltar a sincronizar o áudio com o vídeo, se eles estão fora de sincronizado, após conversion.\r\nA um valor positivo vai atrasar o áudio (vídeo ou seja, à frente de áudio) e um valor negativo será avançado o audio (ou seja, à frente de video).\r\nE.g. 1.5
Media info	Informação de Media
Click here to get media properties for selected files	Clique aqui para obter as propriedades de mídia para arquivos selecionados
Save information	Salvar informações
Add information	Adicionar informações
Shows a preview of the custom filename and path	Mostra uma visualização do nome de arquivo personalizado e caminho
Invalid Filename Pattern	Padrão de nome de arquivo inválido
TVDB Series ID	TVDB série ID
IMDB Series ID	IMDB série ID
Original title	Título original
Corrected title	Título corrigido
Enter the TVDB Series ID you want to use for downloading show information.\r\nIf the Original title box is empty, this will be applied to all shows selected by this conversion task.	Insira o ID de série de TVDB você deseja usar para baixar o programa information.\r\nIf caixa Título Original está vazio, este será aplicado a todos os shows selecionados por esta tarefa de conversão.
Enter the IMDB Movie ID you want to use for downloading movie information.\r\nIf the Original title box is empty, this will be applied to all shows selected by this conversion task.	Insira o ID do filme IMDB você deseja usar para baixar o filme information.\r\nIf o Original título caixa está vazia, isto será aplicado a todos os shows selecionados por esta tarefa de conversão.
Internet Lookup Title and Metadata Correction	Título de pesquisa de Internet e correção de metadados
Click here to add another row to match and correct titles and series id.\r\nIf you want to use the same corrected title or series id for all shows converted by this conversion task,\r\nleave the original title blank on the first row and you should NOT add a second row.	Clique aqui para adicionar outra linha para corresponder e corrigir títulos e série id.\r\nIf você deseja usar o mesmo título corrigido ou identificação de série para todos os shows, convertido por esta tarefa de conversão, \r\nleave o espaço em branco do título original na primeira linha e você não deve adicionar uma segunda linha.
Enter pattern to match show/series titles for correction (e.g. Simpson* will replace all titles that have a show title starting with Simpson)\r\nPrefix pattern with ~ to skip the match (e.g. *.*;~Simpson* will correct all show titles except those that start with Simpson)\r\nSeparate multiple patterns with ; (e.g. Simpson*;House*) or (e.g. Simpson*;NCIS*;~NCIS Miami*)\r\n\r\nNOTE: Leave this box empty if you want to apply the corrected title or series id to ALL files being processed by this conversion task.\r\nIf leaving blank, you cannot add a second row.\r\n\r\nYou can use a regular expression to match the title by starting with regex:	Digite padrão para coincidir com os títulos de série/programa para correção (por exemplo, Simpson * irá substituir todos os títulos que tem mostrar título começando com Simpson) \r\nPrefix padrão com ~ para pular o jogo (por exemplo, *. *; ~ Simpson * corrigirá todos mostram títulos, exceto os que começam com Simpson) \r\nSeparate múltiplos padrões com; (p. ex. Simpson *;House*) ou (p. ex. Simpson *;NCIS*; ~ NCIS Miami *) \r\n\r\nNOTE: Deixe esta caixa vazia se desejar aplicar o título corrigido ou identificação de série para todos os arquivos sendo processados por esta conversão task.\r\nIf deixando em branco, você não pode adicionar um segundo row.\r\n\r\nYou pode usar uma expressão regular para coincidir com o título, iniciando com regex:
Enter the new/corrected title you want to use for downloading additional information from the internet.\r\nIf the Original title box is empty, this will be applied to all shows selected by this conversion task.\r\n\r\nYou can use a regular expression to correct the title by starting with regex:	Digite o título novo/corrigido você deseja usar para fazer o download de informações adicionais da internet.\r\nIf o Original título caixa está vazia, isto será aplicado a todos os shows selecionados por esta conversão task.\r\n\r\nYou pode usar uma expressão regular para corrigir o título iniciando com regex:
For each row, please enter the Original title to match the show name AND either a Corrected title or a TVDB/IMDB Series ID	Para cada linha, por favor, digite o Título Original para coincidir com o nome do programa e também um rectificado título ou uma ID de série TVDB/IMDB
Please enter either a Corrected title or a TVDB/IMDB Series ID	Por favor digite um título rectificado ou um ID de série TVDB/IMDB
Enable this if you want MCEBuddy to put the converted file in the source directory\r\nif the destination path is unavailable. (e.g. Network failure or mapping failure)	Habilitar isso, se você quer MCEBuddy para colocar o convertido arquivo na fonte directory\r\nif o caminho de destino não está disponível. (por exemplo, rede falha ou falha de mapeamento)
Fallback to source path	Retorno para o caminho de origem
Used to increase or decrease the volume of the\r\nrecording while converting.\r\n1 is normal, anything below will reduce it, anything\r\nhigher will increase it.	Usado para aumentar ou diminuir o volume de the\r\nrecording, enquanto converting.\r\n1 é normal, qualquer coisa abaixo irá reduzi-la, anything\r\nhigher aumentará-lo.
Archive folder	Pasta de arquivo
Change the location of the archive folder.\r\nLeave empty to use the default 'MCEBuddyArchive' folder in the original directory.	Altere o local do folder.\r\nLeave arquivo vazio para usar a pasta 'MCEBuddyArchive' de padrão no diretório original.
Monitor subdirectories	Subdiretórios de monitor
Check this box to also monitor all directories within the Monitor path	Seleccione esta caixa para também acompanhar todos os diretórios dentro do caminho de Monitor
Click here to show MCEBuddy status	Clique aqui para visualizar o status de MCEBuddy
MCEBuddy service not connected	Serviço de MCEBuddy não conectado
MCEBuddy idle	MCEBuddy inativo
conversions in progress	conversões em andamento
MCEBuddy stopped	Parou de MCEBuddy
Sync converted files	Sincronizar arquivos convertidos
Check this option if you want MCEBuddy to keep the converted files in sync with the original files.\r\ni.e. When the original files are deleted by the user, the corresponding converted files are also deleted.\r\n\r\nNOTE: MCEBuddy only monitors original files in the monitor locations folders and ONLY while the engine is running.\r\nMCEBuddy will not be able to track user deleted files while the engine is stopped.	Marque esta opção se desejar MCEBuddy para manter os arquivos convertidos em sincronia com o files.\r\ni.e original. Quando os arquivos originais são excluídos pelo usuário, os arquivos convertidos correspondentes também são deleted.\r\n\r\nNOTE: MCEBuddy apenas monitora os arquivos originais nas pastas locais monitor e apenas enquanto o motor estiver running.\r\nMCEBuddy não será capaz de rastrear arquivos de usuário excluído enquanto o motor estiver parado.
Do you wish MCEBuddy to delete each converted file when the original file has been deleted?	Quer MCEBuddy para excluir cada arquivo convertido quando o arquivo original foi excluído?
Confirm sync conversions?	Confirmar conversões de sincronização?
Are you sure you DO NOT want to remove commercials from the converted video and only keep the EDL file?	Tem certeza que você não deseja remover comerciais do vídeo convertido e apenas manter o arquivo EDL?
ShowAnalyzer is not responding. Please the reboot system or reinstall ShowAnalyzer.	ShowAnalyzer não está respondendo. Por favor o sistema reiniciar ou reinstalar ShowAnalyzer.
ShowAnalyzer Not Responding	ShowAnalyzer não está respondendo
Make sure you press 'Start' after closing this window, otherwise Scheduling and Wake will not work.	Certifique-se você pressione 'Start' depois de fechar esta janela, caso contrário de agendamento e Wake não funcionará.
Enabling Scheduling and Wake	Agendamento de habilitação e Wake
Passwords do not match	Senhas não combinam
Password error	Erro de senha
Adding subtitles and chapters to file	Adicionando legendas e capítulos para arquivo
Send eMail if unable to download series information	Enviar E-mail, caso não seja possível fazer download de informações da série
Check this box if you want this conversion task to only process files from specific monitor locations.\r\nIf unchecked each conversion task will process files from all monitor locations (including new ones added later).	Marque esta caixa se você quiser esta tarefa de conversão para apenas processar arquivos de monitor específico locations.\r\nIf desmarcada que cada tarefa de conversão irá processar arquivos de todos os locais de monitor (incluindo os novos adicionados mais tarde).
Select Monitor Locations	Selecione Monitor locais
Select atleast one Monitor Location name	Selecione pelo menos um nome de Monitor local
You have selected all the current Monitor Locations.\r\nDo you want this conversion task to automatically process any new Monitor Locations added in future?	Você selecionou o atual Locations.\r\nDo Monitor você quer nesta tarefa de conversão para processar automaticamente quaisquer novos locais de Monitor adicionado no futuro?
New monitor locations	Novos locais de monitor
Invalid selection	Seleção inválida
Channel name match	Correspondência de nome de canal
Enter pattern to match the channel name for this task (e.g. ABC* will convert all files that recorded on a channel name starting with ABC)\r\nPrefix pattern with ~ to skip the match (e.g. *;~ABC* will process all channels except those that start with ABC)\r\nSeparate multiple patterns with ; (e.g. ABC*;TBS*) or (e.g. ABC*;Fox*;~Fox4*)\r\n\r\nYou can use regular expressions to match the pattern by starting with regex:	Digite padrão para coincidir com o nome do canal para esta tarefa (por exemplo, ABC * irá converter todos os arquivos gravados em um nome de canal, começando com ABC) \r\nPrefix padrão com ~ para pular o jogo (por exemplo, *; ~ ABC * irá processar todos os canais, exceto aqueles que comecem com ABC) \r\nSeparate múltiplos padrões com; (por exemplo, ABC *;TBS*) ou (por exemplo, ABC *;Fox*; ~ Fox4 *) \r\n\r\nYou pode usar expressões regulares para corresponder ao padrão, iniciando com regex:
Clear history	Limpar histórico
Click this button to clear the history of all converted files.\r\nThis is cause MCEBuddy to reconvert all files being monitored.	Clique neste botão para limpar o histórico de todos os files.\r\nThis convertido é causar MCEBuddy reconverter todos os arquivos que está sendo monitorados.
Are you sure you want to clear the history of all conversions?\r\nThis will cause MCEBuddy to reconvert all files being monitored.	Tem a certeza de que deseja limpar o histórico de todas as conversões? \r\nThis fará com que MCEBuddy a reconversão de todos os arquivos que está sendo monitorados.
Show history	Mostrar a história
Click this button to show the history of all converted files.	Clique neste botão para visualizar o histórico de todos os arquivos convertidos.
History of Converted Files	História dos arquivos convertidos
Unable to communicate with engine.	Incapaz de se comunicar com o motor.
Extracting streams	Extração de fluxos
Fallback muxing streams	Fluxos de fallback muxing
Remuxing TiVO file	Arquivo de Remuxing TiVO
Enter your 10 digit TiVO MAK key to convert and process TiVO recordings	Inserir o dígito 10 chave MAK TiVO para converter e processar TiVO gravações
Invalid TiVO MAK Key	Chave inválida TiVO MAK
The TiVO MAK key should be 10 digits	A chave MAK TiVO deve ser de 10 dígitos
Version mismatch. Please ensure that the MCEBuddy client and engine are running the same version.	Incompatibilidade de versão. Certifique-se de que o cliente MCEBuddy e o motor estão executando a mesma versão.
Error retrieving Event Logs	Erro ao recuperar os Logs de eventos
Unable to get Event Log Entries from the MCEBuddy engine.	Não é possível obter as entradas de Log de eventos do motor MCEBuddy.
PAUSED: Check conversion schedule	PAUSADO: Cronograma de conversão de seleção
Logging	Log
Folder Management	Gerenciamento de pastas
Processor Management	Gerenciamento de processador
Expert Settings	Especialista em configurações
System Settings	Configurações do sistema
Click here to change additional settings (for experts only)	Clique aqui para alterar configurações adicionais (para os peritos somente)
Failed folder	Falha na pasta
Location of the folder that hold the original files for failed conversions.	Localização da pasta que mantenha os arquivos originais para conversões de falhadas.
Move original file on failure	Mover o arquivo original em caso de falha
Check this to move the original file to a separate folder if the conversion fails.	Verificar isso para mover o arquivo original para uma pasta separada, se a conversão falhar.
Check this to limit the number of logical processors that MCEBuddycan use.\r\nEach check box below corresponds to an available logical processor.	Verificar isso para limitar o número de processadores lógicos que MCEBuddycan use.\r\nEach caixa de seleção abaixo corresponde a um processador lógico disponível.
Each box represents logical processors from 1 to 16 respectively.\r\nChecking a box allows MCEBuddy to use that processor.	Cada a caixa representa o processadores lógicos de 1 a 16 respectively.\r\nChecking uma caixa permite que MCEBuddy usar esse processador.
Each box represents logical processors from 17 to 32 respectively.\r\nChecking a box allows MCEBuddy to use that processor.	Cada a caixa representa o processadores lógicos de 17 a 32 respectively.\r\nChecking uma caixa permite que MCEBuddy usar esse processador.
Select atleast one processor to use	Selecione pelo menos um processador usar
Invalid Configuration	Configuração inválida
Comskip path	Comskip caminho
If you want to use a custom version of Comkip (e.g. donator version)\r\nthen enter the path of the comskip installation here.\r\nLeave blank to use the default comskip that comes with MCEBuddy.	Se você quiser usar uma versão personalizada do Comkip (por exemplo, a versão de doador) \r\nthen digite o caminho da instalação de comskip here.\r\nLeave em branco para usar o comskip padrão que vem com MCEBuddy.
Miscellaneous	Diversos
Ignore copy protection	Ignorar a proteção contra cópia
Check this to ignore the copy protection flag on video file while converting.\r\nNOTE: MCEBuddy cannot bypass encryption, this only helps if a file is incorrectly\r\ntagged as copy protected when it is NOT encrypted.	Verificar isto para ignorar a bandeira de proteção contra cópia no arquivo de vídeo enquanto converting.\r\nNOTE: MCEBuddy não pode ignorar a criptografia, isso só ajuda se um arquivo é incorrectly\r\ntagged como cópia protegida quando não está criptografado.
Use recycle bin	Lixeira de uso
Check this to use the recycle bin when files are deleted by MCEBuddy	Verificar isso para usar a Lixeira quando arquivos são excluídos por MCEBuddy
Poll period	Período de votação
This is how often MCEBuddy scans the Monitor Tasks Locations for new files.\r\nThe interval is specified in seconds.	Esta é a freqüência MCEBuddy examina os locais de tarefas do Monitor novo intervalo de files.\r\nthe é especificado em segundos.
Server port	Porta do servidor
This is the TCP port MCEBuddy uses to communicate with the remote engine.\r\nWhen UPnP is enabled, MCEBuddy will automatically add this port to the Windows Firewall\r\nand UPnP gateway to allow access from the internet on this port.	Esta é a porta TCP que mcebuddy usa para se comunicar com o engine.\r\nWhen remoto UPnP está habilitado, MCEBuddy adicionará automaticamente esta porta para o gateway do Windows Firewall\r\nand UPnP para permitir o acesso da internet nesta porta.
Hang period	Pendurar o período
Enter the number of seconds that MCEBuddy will wait for a response from the\r\nunderlying application before terminates the application as hung.\r\nEnter 0 to disable hang detection.	Digite o número de segundos que MCEBuddy irá esperar por uma resposta de the\r\nunderlying aplicação antes encerra o aplicativo como hung.\r\nEnter 0 para desabilitar a detecção de pendurar.
Subtitle commercial cut sync	Subtítulo comercial corte sync
This parameter is used when the subtitles go progressively out of sync after each commercial segment is removed from the video.\r\nThis setting is used to bring the subtitles back into sync with the video.\r\nEach time the video commercial is cut out, the subtitles are time shifted by this amount (+ve or -ve in seconds).	Este parâmetro é usado quando as legendas vá progressivamente fora de sincronia, após cada segmento comercial é removido da configuração video.\r\nThis é usada para trazer as legendas de volta na sincronização com a hora de video.\r\nEach que o vídeo comercial é cortado, as legendas são deslocado por este montante (+ ve ou - ve em segundos) de tempo.
Invalid poll period	Período de votação inválida
Invalid server port	Porta do servidor inválido
eMail Subject Customization	E-mail assunto personalização
Use this section to customize the subject of eMail sent by MCEBuddy on the various conversion events listed below.\r\nRefer to the documentation, custom commands for user defined variables.\r\ne.g. Show %showname% for file %originalfilename% conversion successful using task %taskname%\r\nNOTE: Not always will all the data be available in the custom commands.\r\nLeave blank to use default subject lines.	Uso desta seção para personalizar o assunto do E-mail enviada por MCEBuddy em vários eventos de conversão listados below.\r\nRefer a documentação, comandos personalizados para variables.\r\ne.g definidos pelo usuário. Mostrar showname % para arquivo % originalfilename % conversão bem-sucedida usando a tarefa % taskname%\r\nNOTE: nem sempre todos os dados estarão disponíveis no commands.\r\nLeave personalizada em branco para usar linhas de assunto padrão.
Success	Sucesso
Failed	Falhou
Cancelled	Cancelado
Download fail	Download fail
Limit processor utilization	Limite de utilização de processador
Check this to limit the number of logical processors that MCEBuddy can use.\r\nEach check box below corresponds to an available logical processor.	Verifique isso para limitar o número de processadores lógicos que MCEBuddy pode use.\r\nEach caixa de seleção abaixo corresponde a um processador lógico disponível.
Custom profile	Perfil personalizado
If you have a custom profiles.conf file that you want to use instead of the\r\none that comes with MCEBuddy, enter the path to the file here.\r\n\r\nNOTE: MCEBuddy constantly updates profiles.conf to provide bug fixes,\r\nenhancements and performance improvements which you will miss out\r\non if you use this feature.	Se você tiver um arquivo de profiles.conf personalizada que você deseja usar em vez de the\r\none que vem com MCEBuddy, digite o caminho para o arquivo here.\r\n\r\nNOTE: MCEBuddy constantemente atualizações profiles.conf fornecer bug fixes, aprimoramentos de desempenho e \r\nenhancements que você vai perder out\r\non, se você usar esse recurso.
Invalid custom profiles.conf	Profiles.conf personalizado inválido
Suspend on battery	Suspender na bateria
Suspend conversions when the computer switches to battery power	Suspender conversões quando o computador desliga a energia da bateria
MCEBuddy added a video conversion to the queue	MCEBuddy adicionou uma conversão de vídeo para a fila
Queue	Fila
Refer to documentation on using custom commands in custom eMail subjects	Consulte a documentação sobre como usar comandos personalizados em assuntos de E-mail personalizado
Could not copy information to Clipboard, please try again.	Não pode copiar informações de transferência, por favor, tente novamente.
Error copying to Clipboard	Erro ao copiar para área de transferência
Copy to clipboard	Copiar para área de transferência
Reconvert files	Reconverter os arquivos
Are you sure you want to reconvert the selected files?	Tem certeza que deseja reconverter os arquivos selecionados?
Select the files you want to reconvert and then click this button.\r\nIf the original files are still being monitored by MCEBuddy they will be queued for reconversion.	Selecione os arquivos que você deseja reconverter e, em seguida, clique nesta button.\r\nIf que os arquivos originais ainda estão sendo monitorados por MCEBuddy, eles serão enfileirados para reconversão.
Time taken to convert	Tempo necessário para converter
Network authentication	Autenticação de rede
Click the button to enter the network shares credentials.\r\nThis authentication is used when files are added via the Add button on the main window\r\nor dragged and dropped from a network share into the conversion status box on the main window.	Clique no botão para aceder a autenticação de credentials.\r\nThis de compartilhamentos de rede é usado quando os arquivos são adicionados através do botão Add na window\r\nor principal arrastado e solto em um compartilhamento de rede na caixa de status de conversão na janela principal.
Skip reconversion	Reconversão de Skip
Do not reconvert the video if a converted file already exists in the destination directory.	Não reconverter o vídeo, se um arquivo convertido já existir no diretório de destino.
The expected filename for the converted video (not the original video filename) is compared with the filenames in the destination directory.\r\nIf the converted file exists, the file will not be reconverted and it will be assumed to be a successful conversion.\r\nThis is useful if the same show/episode is being recorded on multiple times and you don't want to reconvert them.\r\n\r\nNOTE: This option is ignored for videos that are added manually using the add button or dragging and dropping	O nome de arquivo esperada para o vídeo convertido (não o arquivo de vídeo original) é comparado com os nomes dos arquivos no directory.\r\nIf destino existe o arquivo convertido, o arquivo não irá ser reconverted e presume-se ser uma conversion.\r\nThis bem sucedida é útil se o mesmo show/episódio está sendo gravado em várias vezes e não quer reconverter them.\r\n\r\nNOTE: Esta opção é ignorada para os vídeos que são adicionados manualmente usando o botão Adicionar ou arrastando e soltando
If enabled, skip reconversion will also check the history file for past conversions.\r\nThe expected filename for the converted video (not the original video filename) is compared with the filenames in the history file.\r\nIf the to be converted filename (including path) matches any of the already converted filenames (including paths) in the history file,\r\nthe file will not be reconverted and it will be assumed to be a successful conversion.	Se habilitado, reconversão de skip também irá verificar o arquivo de histórico para últimos conversions.\r\nThe esperado de nome de arquivo para o vídeo convertido (não o arquivo de vídeo original) é comparado com os nomes dos arquivos em file.\r\nIf a história a ser o nome do arquivo convertido (incluindo o caminho) corresponde a qualquer um dos nomes dos arquivos já convertidos (incluindo caminhos) no arquivo histórico, arquivo \r\nthe não irá ser reconverted e presume-se ser uma conversão bem-sucedida.
Adding file to the iTunes library	Adicionar arquivo à biblioteca do iTunes
Add to iTunes	Adicionar ao iTunes
Check this box to automatically add the converted files to the iTunes library.\r\nThis only works with iTunes supported files (e.g. MP4, M4V, MP3 etc)	Verifique esta caixa para adicionar automaticamente os arquivos convertidos para o iTunes library.\r\nThis só funciona com o iTunes arquivos suportados (por exemplo, MP4, M4V, MP3 etc.)
Adding file to the WMP library	Adicionar arquivo à biblioteca do WMP
Library Management	Gestão de biblioteca
Add to Windows Media Player	Adicionar ao Windows Media Player
Check this box to automatically add the converted files to the WMP library.	Marque esta caixa para adicionar automaticamente os arquivos convertidos para a biblioteca do WMP.
Renaming and Sorting	Renomeando e classificação
Selection Filters	Filtros de seleção
Audio and Video	Áudio e vídeo
Subtitles and Chapters	Legendas e capítulos
Skip copying original files	Skip copiando arquivos originais
CHECK THIS BOX AT YOUR OWN RISK.\r\nDO NOT CHECK THIS BOX UNLESS YOU KNOW WHAT YOU ARE DOING.\r\nCheck this box to skip making a backup of original file (copying) while converting.	Verifique esta caixa em seu próprio RISK.\r\nDO não verifique esta caixa a menos que você sabe o que você está DOING.\r\nCheck esta caixa para ignorar a fazer um backup do arquivo original (cópia) durante a conversão.
CHECK THIS BOX AT YOUR OWN RISK.\r\nDO NOT CHECK THIS BOX UNLESS YOU KNOW WHAT YOU ARE DOING.\r\nCheck this box to skip making a backup of original file (copying) while converting.\r\nIf this is checked, the original file will not be preserved in case of an error.\r\nIt can also even lead to conversion failures or other unforeseen conversion issues.	Verifique esta caixa em seu próprio RISK.\r\nDO não marque esta caixa se você não sabe o que é esta caixa para ignorar a fazer um backup do arquivo original (cópia) enquanto converting.\r\nIf isto é marcada, o arquivo original não será preservado no caso de um error.\r\nIt de DOING.\r\nCheck também ainda pode levar a falhas de conversão ou outras questões de conversão imprevistas.
Are you sure you want to do this?	Tem certeza que quer fazer isso?
Media Information Management	Gerenciamento de informações de mídia
Force show type	Tipo de mostrar força
Set this to force treating the video recording as a Movie or TV Series.\r\nThis will change the way additional information (metadata) about the recording is downloaded from the internet.\r\nMovie - Treat the recording as movie\r\nSeries - Treat the recording as a TV Series\r\nSports - Treat the recording as a Sports show\r\nDefault - Use the default information available in the recording metadata to determine Movie or TV Series	Definir isso para forçar a tratar o gravação como um filme de vídeo ou TV Series.\r\nThis vai mudar a maneira que informações adicionais (metadados) sobre a gravação são baixadas o internet.\r\nMovie - tratar a gravação como movie\r\nSeries - tratar a gravação como um Series\r\nSports de TV - tratar a gravação como uma show\r\nDefault de esportes - uso as informações padrão disponíveis em gravação de metadados para determinar o filme ou série de TV
Show type	Tipo de programa
Select this to filter the type of recordings being converted.\r\n\r\nMovies - select this to convert if the show type is Movie.\r\nShows - select this to convert if the show type is NOT a Movie.\r\nSports - select this to convert if the show type is Sports.\r\n\r\nNOTE: Show type is read from the recording metadata.\r\nOnly some recordings support show type metadata such as WTV and\r\nrecordings with supporting metadata files (XML/ARG etc).	Selecione esta opção para filtrar o tipo de gravações, sendo converted.\r\n\r\nMovies - Selecione esta opção para converter-se o tipo de show é Movie.\r\nShows - Selecione esta opção para converter-se o tipo de espetáculo não é um Movie.\r\nSports - Selecione esta opção para converter-se o tipo de programa é Sports.\r\n\r\nNOTE: mostrar tipo é lido a partir da gravação metadata.\r\nOnly suportam a algumas gravações arquivos de metadados de tipo mostrar como WTV and\r\nrecordings com suporte a metadados (XML/ARG etc).
This box shows all the files in queue for conversion.\r\nDrag and drop files here or press the Add button to add files to the conversion queue	Esta caixa mostra todos os arquivos na fila para conversion.\r\nDrag e soltar arquivos aqui ou pressione o botão Adicionar para adicionar arquivos para a fila de conversão
Conversion	Conversão
Files	Arquivos
Click this button to open or close the Advanced Settings section	Clique neste botão para abrir ou fechar a seção de configurações avançadas
Running custom commands	Executando comandos personalizados
Trimming video recording	Aparar a gravação de vídeo
Insert at top of queue	Inserir no topo da fila
By default, new conversions are added to the bottom (end) of the conversion queue.\r\nIf this box is checked, any new conversions added by this task will be added to the\r\nbeginning (top) of the conversion queue.	Por padrão, novas conversões são adicionadas ao fundo (final) a conversão queue.\r\nIf esta caixa é marcada, qualquer conversões novos adicionados por esta tarefa serão adicionadas ao the\r\nbeginning (topo) da fila de conversão.
Add subtitles and chapters	Adicionar legendas e capítulos
Enable this option to add any extracted subtitles and chapters to the converted video.\r\nEach chapter marks the end of a commercial. This only works with supported formats (e.g. MKV, MP4).\r\n\r\nNOTE: Some players and older TV's don't support embedded subtitles and chapters.\r\nIf you're unable to playback the converted video's, try turning this option off.	Habilite esta opção Adicionar qualquer Legendas extraídas e capítulos o capítulo convertido video.\r\nEach marca o fim de um comercial. Isso só funciona com os formatos suportados (por exemplo, MKV, MP4).\r\n\r\nNOTE: alguns jogadores e TVs mais antigas não suportam legendas incorporadas e chapters.\r\nIf você é incapaz de reproduzir o vídeo convertido, tente desativar esta opção.
Select best soundtrack	Selecione a melhor trilha sonora
If the original video has multiple soundtracks, this option tells MCEBuddy to select the most appropriate and primary soundtrack.\r\nIf you want a specific language soundtrack, make sure you enter the language name or code in the Audio Language box.\r\nCheck this box if you're hearing the wrong soundtrack in your converted file.\r\n\r\nUncheck this box if you want MCEBuddy to retain all the soundtracks from the original video in the converted file when possible.\r\nNOTE:Some profiles do not support multiple soundtracks, in which case this setting has no effect.	Se o vídeo original tem várias trilhas sonoras, essa opção informa MCEBuddy para selecionar o mais adequado e primário soundtrack.\r\nIf você quer uma trilha sonora de idioma específico, certifique-se de inserir o nome de linguagem ou código em box.\r\nCheck o idioma áudio esta caixa se você está ouvindo a trilha sonora errada em seu file.\r\n\r\nUncheck convertido esta caixa se você quer MCEBuddy para reter todas as trilhas sonoras do vídeo original no arquivo convertido, quando possível. \r\nNOTE: alguns perfis não suporta múltiplas trilhas sonoras, caso em que essa configuração não terá efeito.
Enable remote access	Habilitar o acesso remoto
This creates an exception in the windows firewall for MCEBuddy application and the port.\r\nThis is required if you have windows firewall enabled and want to use UPnP, the remote client\r\nor access the engine using an IP address.\r\n\r\nNOTE: If you have a custom firewall, this may not work, you will need to manually create an\r\nexception for MCEBuddy service and the port.	Isso cria uma exceção no firewall do windows para o aplicativo MCEBuddy e o port.\r\nThis é necessária se você tiver habilitado o firewall do windows e quiser usar UPnP, o acesso remoto client\r\nor o motor usando um IP address.\r\n\r\nNOTE: se você tem um firewall personalizado, isso pode não funcionar, você precisará criar manualmente an\r\nexception para serviço de MCEBuddy e do porto.
Unable to communicate with engine. Firewall exception settings have not been updated.	Incapaz de se comunicar com o motor. As configurações de exceção do firewall não foram atualizadas.
Detect and optimize video quality	Detectar e otimizar a qualidade de vídeo
When enabled, MCEBuddy will optimize the video processing options by trying to detect the video source type.\r\nThis can improve the quality of the converted video significantly if correctly detected.\r\n\r\nNOTE: It does this by trying to detect the video source type (interlaced, progressive or telecine).\r\nIf it is able to detect the video source type, it will override the corresponding parameters in the profile.\r\nTurn this option off if you are facing issues with converted video quality or want to use the default profile parameters.	Quando habilitado, o MCEBuddy irá otimizar as opções de processamento de vídeo por tentar detectar o type.\r\nThis fonte de vídeo pode melhorar a qualidade do vídeo convertido significativamente se corretamente detected.\r\n\r\nNOTE: ele faz isso, tentar detectar o tipo de fonte de vídeo (entrelaçado, progressivo ou telecine).\r\nIf é capaz de detectar o tipo de fonte de vídeo, ele substituirá os parâmetros correspondentes no profile.\r\nTurn esta opção fora se você está enfrentando problemas com a qualidade do vídeo convertido ou quer usar os parâmetros do perfil padrão.
Are you sure you want to delete this task?	Tem certeza que deseja excluir esta tarefa?
Delete Task	Excluir tarefa
Enter the new task name	Digite o novo nome da tarefa
Rename Task	Renomear a tarefa
MCEBuddy PAUSED	MCEBuddy em pausa
idle	ocioso
PAUSED	EM PAUSA
Frame rate	Taxa de quadros
Enable this to set a custom framerate (FPS) for the converted video.\r\nYou may need to set this while converting video formats (e.g. PAL to NTSC)\r\nor for devices which support only specific framerates.\r\n\r\nE.g.: 25\r\nE.g.: 30000/1001	Ativar este definir um personalizado framerate (FPS) para o video.\r\nYou convertido pode precisa definí-la durante a conversão de formatos de vídeo (por exemplo, PAL para NTSC) \r\nor para dispositivos que suportam apenas específico framerates.\r\n\r\nE.g.: 25\r\nE.g.: 30000/1001
Skip remuxing files	Skip remuxing arquivos
CHECK THIS BOX AT YOUR OWN RISK.\r\nDO NOT CHECK THIS BOX UNLESS YOU KNOW WHAT YOU ARE DOING.\r\nCheck this box to skip remuxing the original file to a TS file while converting.\r\nIf this is checked, some functions like subtitle extraction or comskip may not work.\r\nIt can also even lead to conversion failures or other unforeseen conversion issues.	Verifique esta caixa em seu próprio RISK.\r\nDO não marcar esta caixa, a menos que você saiba o que você está DOING.\r\nCheck esta caixa para saltar remuxing o arquivo original para um arquivo TS enquanto converting.\r\nIf isto é verificado, algumas funções como extração de legendas ou comskip pode não work.\r\nIt também ainda pode levar a falhas de conversão ou outras questões de conversão imprevistas.
CHECK THIS BOX AT YOUR OWN RISK.\r\nDO NOT CHECK THIS BOX UNLESS YOU KNOW WHAT YOU ARE DOING.\r\nCheck this box to skip remuxing the original file to a TS file while converting.	Verifique esta caixa em seu próprio RISK.\r\nDO não verifique esta caixa a menos que você sabe o que você está DOING.\r\nCheck esta caixa para saltar remuxing o arquivo original para um arquivo TS durante a conversão.
Monitor converted videos	Monitorar os vídeos convertidos
By default Monitor Locations will ignore files that have already been converted.\r\nCheck this box if you also want to monitor converted files in the Monitor Path.\r\nCAUTION: This can lead to an infinite conversion loop of converted files if not configured properly.\r\n\r\nThis can be useful when you are specifying the output directory of a conversion task\r\n(converted file) as the Monitor Path of a Monitor Location and linking the\r\nMonitor Location to another conversion task.	Por padrão Monitor locais irá ignorar arquivos que já foram converted.\r\nCheck esta caixa se você também deseja monitorar arquivos convertidos em Path.\r\nCAUTION o Monitor: isso pode levar a um loop infinito de conversão de arquivos convertidos, se não configurado properly.\r\n\r\nThis pode ser útil quando você está especificando o diretório de saída de um task\r\n de conversão (arquivo convertido) como o caminho do Monitor de um Monitor local e ligando the\r\nMonitor Localização para outra tarefa de conversão.
CHECK THIS BOX AT YOUR OWN RISK.\r\nDO NOT CHECK THIS BOX UNLESS YOU KNOW WHAT YOU ARE DOING.\r\nBy default Monitor Locations will ignore files that have already been converted.\r\nCheck this box if you also want to monitor converted files in the Monitor Path.	Verifique esta caixa em seu próprio RISK.\r\nDO não verificar esta caixa a menos que você sabe o que você está DOING.\r\nBy Monitor locais padrão irá ignorar arquivos que já foram converted.\r\nCheck esta caixa se você também deseja monitorar arquivos convertidos no caminho do Monitor.
Hardware encoding	Hardware de codificação
Check this box to use hardware encoding when available to convert videos.\r\nThis can speed up the conversion significantly and reduce the CPU utilization\r\nbut it can result in slightly lower quality videos.\r\n\r\nUncheck this box if you're facing conversion or quality issues.	Verifique esta caixa para usar hardware de codificação quando disponível para converter videos.\r\nThis pode acelerar a conversão significativamente e reduzir o utilization\r\nbut de CPU pode resultar em ligeiramente mais baixa qualidade videos.\r\n\r\nUncheck esta caixa se você está enfrentando problemas de qualidade ou de conversão.
Do not overwrite files	Não substitui os arquivos
When this box is checked, the destination file will not be overwritten if it already exists.\r\nInstead a new file will be created with a unique number added to the end of the filename.	Quando esta caixa é marcada, o arquivo de destino não será sobrescrito se ele já exists.\r\nInstead um novo arquivo será criado com um número único adicionado ao final do nome do arquivo.
Re-monitor recorded videos	Re-monitorar vídeos gravados
By default, once a source file (Recorded video) has been converted,\r\nthe monitor history will track the filename and not queue the same files again.\r\n\r\nEnable this option to ignore the history and monitor all files and add them to\r\nthe conversion queue, even if they have already been converted.\r\n\r\nThis can be useful sometimes, if the recording software does not generate a\r\nunique filename for each episode/show. It is reccomended to use the\r\nDelete original file option in the Settings page when using this option to avoid\r\nan infinite conversion loop.	Por padrão, uma vez que um arquivo de origem (gravado em vídeo) foi convertido, história de monitor \r\nthe irá controlar o nome do arquivo e não fila os mesmos arquivos again.\r\n\r\nEnable essa opção para ignorar a história e monitorar todos os arquivos e adicioná-los to\r\nthe fila de conversão, mesmo se eles já foram converted.\r\n\r\nThis pode ser útil às vezes, se o software de gravação não gera a\r\nunique nome do arquivo para cada episódio/show. É recomendado usar opção de arquivo original the\r\nDelete na página de configurações, ao usar esta opção para loop infinito de conversão de avoid\r\nan.
Recommendation	Recomendação
To avoid an infinite conversion loop, it is recommended to setup your Monitor search pattern in a way such as to ensure that the converted files are not being monitored by this Monitor task.	Para evitar um loop infinito de conversão, é recomendável configurar o seu padrão de pesquisa de Monitor em uma maneira como para garantir que os arquivos convertidos não estão sendo monitorados por esta tarefa do Monitor.
CHECK THIS BOX AT YOUR OWN RISK.\r\nDO NOT CHECK THIS BOX UNLESS YOU KNOW WHAT YOU ARE DOING.\r\nBy default Monitor Locations will not remonitor recorded videos that have been processed.\r\nCheck this box if you want to remonitor and reconvert the recorded videos.	Verifique esta caixa no seu próprio padrão de RISK.\r\nDO não verificar esta caixa a menos que você sabe o que você está DOING.\r\nBy que monitor locais não será remonitor gravou vídeos que foram processed.\r\nCheck esta caixa se você quer remonitor e reconverter os vídeos gravados.
To avoid an infinite conversion loop, it is recommended that you enable Delete original file option in the Settings page.	Para evitar um loop infinito de conversão, é recomendável que você ative a opção de excluir arquivo original na página de configurações.
Prioritize air date matching	Priorizar a correspondência de data do ar
MCEBuddy uses the episode name to match the series information\r\nwhile searching the internet. If that fails then it uses the original broadcast\r\nair date to match the metadata.\r\n\r\nCheck this box to use the original broadcast air date first and then the\r\nepisode name to match for the series information from the internet.\r\nThis can be useful in some cases when multiple seasons have the same\r\nepisode name. E.g. Americal Idol, Audition 1\r\n\r\nNOTE: Original broadcast air date is not always accurate set by the\r\nbroadcaster and sometimes the information on the internet is incorrect.\r\nUse this option only if the default option is not working for you.	MCEBuddy usa o nome do episódio para coincidir com o information\r\nwhile de série pesquisando na internet. Se isso falhar, então ele usa a original data de broadcast\r\nair para coincidir com o metadata.\r\n\r\nCheck esta caixa para usar a data original do ar difusão primeiro e então the\r\nepisode nome para coincidir com as informações de série desde o internet.\r\nThis pode ser útil em alguns casos, quando várias temporadas tem o nome de same\r\nepisode. Por exemplo, Americal Idol, audição 1\r\n\r\nNOTE: Original data de difusão de ar não é sempre exato definido pelo the\r\nbroadcaster e às vezes as informações na internet são incorrect.\r\nUse esta opção apenas se a opção padrão não está funcionando para você.
Skip eMail body	Skip E-mail corpo
Check this option to use an empty body in the notification eMail.\r\nThis can be useful if you're using a SMS gateway for eMail notifications.	Verifique esta opção para usar um corpo vazio em eMail.\r\nThis a notificação pode ser útil se você estiver usando um gateway SMS para notificações por eMail.
Selection based on Digital Right Management (DRM) is available\r\nonly when Rename without converting (Rename and move only) option is selected.\r\n\r\nAll - Selects all files for processing, irrespective of copy protection status\r\nProtected - Only select files which are copy protected\r\nUnprotected - Only select files which do not have copy protection	Seleção baseada na gestão de direito digitais (DRM) é available\r\nonly quando renomear sem converter (renomear e mover somente) opção é selected.\r\n\r\nAll - seleciona todos os arquivos para processamento, independentemente da proteção de cópia status\r\nProtected - somente selecionar arquivos que são cópia protected\r\nUnprotected - apenas selecione os arquivos que não têm proteção contra cópia
Download cover art	Baixar a arte da capa
Enable this to download the cover art from the original video and internet if available.	Ativar este baixar a arte da capa do vídeo original e internet, se disponível.
Are you sure you want to enter a Domain Name?\r\n\r\nUse this ONLY if you are using a Windows Domain Controller to manage your authentication.\r\nDo NOT use this if you are part of a Workgroup.\r\n\r\nIf you are unsure click NO.	Tem certeza que deseja introduzir um nome de domínio? \r\n\r\nUse este somente se você estiver usando um controlador de domínio do Windows para gerenciar seu authentication.\r\nDo não usar isto se você faz parte de um Workgroup.\r\n\r\nIf você é inseguro clique não.
Configuration Warning	Aviso de configuração
Creates a folder called 'MCEBuddyArchive' where the original file is located\r\nand moves the orginal file in this directory after a successful conversion.\r\n\r\nThis folder name and location be changed below.	Cria uma pasta chamada 'MCEBuddyArchive', onde está o arquivo original located\r\nand move o arquivo original neste diretório após um bem sucedido conversion.\r\n\r\nThis nome da pasta e o local ser alterado abaixo.
Monitoring	Monitoramento
If you want to convert the EDL file into chapters, make sure you check the 'Add Subtitles and Chapters' option in Expert Settings.	Se você deseja converter o arquivo de EDI em capítulos, certifique-se de que você marcar a opção 'Adicionar legendas e capítulos' nas configurações de especialista.
EDL to Chapters	EDI em capítulos.
