MCEBuddy does NOT use the currently logged in user to connect to network shares, it uses its own service account.  Be sure to specify the connection user information (MCEBuddy with a key icon)	MCEBuddy не использовать текущего пользователя для подключения к сетевым ресурсам, он использует свою собственную учетную запись службы.  Не забудьте указать пользователя сведения о подключении (MCEBuddy со значком ключа)
Connection Reminder	Подключение напоминание
Description	Описание
Path	Путь
is invalid	Недопустимый
Invalid Path	Недопустимый путь
Please supply a task name	Приведите название задачи
No name supplied	Имя не поставляется
Please enter the 3 digit language code of the Audio track or select <Default> or <Original>	Пожалуйста, введите 3 цифры языка звуковой дорожке или выберите <Default>или <Original>
The 3 digit ISO code for the selected language\r\nMake sure this matches the language code for the audio track in the original recording.\r\nTo get the language code for the audio tracks in the original recorded file, add the file\r\nto the queue and right click on it. A pop up window will open showing the audio details\r\nwhich include the language codes for each audio track.	3 Значный код ISO для выбранного language\r\nMake уверен, что это соответствует код языка для звуковой дорожки в первоначальной получить recording.\r\nTo код языка для звуковых дорожек в исходный записанный файл, добавьте file\r\nto очереди и щелкните правой кнопкой мыши на ней. Всплывающее окно будет открыто показывая аудио details\r\nwhich включают в себя языковые коды для каждой звуковой дорожки.
Invalid Language Code	Недопустимый код языка
No destination directory provided, converted file will be placed in original video directory	Каталог назначения не предусмотрено, преобразованный файл будет помещен в оригинальные видео-каталог
A task name or section	Название задачи или раздел
already exists\n\rPlease use another name	уже exists\n\rPlease использовать другое имя
Duplicate Name	Повторяющееся имя
Engine	Двигатель
Tasks	Задачи
Profile	Профиль
disposing	Удаление
Task name	Название задачи
Give a unique name to this task	Задайте уникальное имя для этой задачи
Gives a short description for the selection conversion profile	Дает краткое описание для выбора профиля преобразования
Click to select destination folder	Щелкните, чтобы выбрать папку назначения
Destination	Пункт назначения
Select the directory where the converted file will be placed.\r\nLeave this blank to keep the converted file in the same directory as the original video.	Выберите каталог, в котором преобразованный файл будет placed.\r\nLeave это поле пустым, чтобы сохранить преобразованный файл в том же каталоге, что и оригинал видео.
Max width	Максимальная ширина
This will limit the maximum width (in pixels) of the video for the converted file.\r\nTIP: Does not apply if the original file has a width smaller than this number.\r\nIf you want to keep your original video resolution move the slider all the way to the right.	Это будет ограничивать максимальную ширину (в пикселах) видео для преобразованной file.\r\nTIP: не применяется, если исходный файл имеет ширину меньше, чем этот number.\r\nIf, вы хотите сохранить ваш оригинальный ход видеоразрешение ползунок вплоть до права.
Quality	Качество
Ad remover	AD remover
None	Нет
Get series details from Internet	Получение серии деталей из Интернета
Download additional details about the movie or series from the internet	Скачать дополнительные сведения о серии или фильм из Интернета
File name match	Матч имя файла
Recording title match	Запись матч
Cancel	Отмена
OK	Хорошо
Rename without converting	Переименовать без преобразования
Check this option to only rename and copy the original files to the destination folder.\r\nWhen checked, conversion, trimming, audio/video processing and commercial removal will not be available.\r\n\r\nNOTE: Other functions like matching filters, extracting subtitles, saving metadata and commercial detection (saving EDL file)\r\nwill still be available with this option checked.\r\nIf you want to move instead of copy, check the Skip copying original option in Expert Settings on this page or select\r\nDelete original file in the main settings page.	Проверить этот флажок только переименование и копирование исходных файлов для назначения folder.\r\nWhen установлен, преобразования, обрезки, аудио/видео обработки и коммерческие удаления не будет available.\r\n\r\nNOTE: другие функции как фильтры, извлечение субтитры, сохранение метаданных и коммерческого обнаружения (сохранение EDL файлов) \r\nwill все еще быть доступны с этой checked.\r\nIf вариант вы хотите переместить вместо копирования, проверьте пропустить копирование оригинальный вариант в параметрах эксперта на этой странице или select\r\nDelete исходный файл на странице Основные настройки.
Rename and sort by video information	Переименуйте и сортировать по видеоинформации
Renames the converted file and places it in a new directory based on the show/series information when available\r\n(e.g. ShowName\\ShowName-SXXEYY-EpisodeName-RecordDate)	Переименовывает преобразованный файл и помещает его в новый каталог на основе информации серии/шоу когда available\r\n (например ShowName\\ShowName-SXXEYY-EpisodeName-RecordDate)
Enter the username and password to access folders that are on a network drive or a different computer	Введите имя пользователя и пароль для доступа к папкам, которые находятся на сетевом диске или на другом компьютере
Organize by seasons	Организовать по сезонам
Organize folders by Showname and Season when available (Media Center/XBMC/Plex compatible naming convention)\r\n(e.g. Showname\\Season XX\\SXXEYY-Episode Name)	Организовать папки по Showname и сезон, когда доступны (Media Center/XBMC/Plex совместимый именования) \r\n (например, имя Showname\\Season XX\\SXXEYY-эпизод)
Audio language	Язык аудио
Advanced Settings	Дополнительные параметры
General Settings	Общие параметры
Conversion Task	Задача преобразования
Password	Пароль
Confirm Password	Подтверждение пароля
Domain / computer name	Домен / имя компьютера
<Optional> Enter if remote computer or network drive uses a Domain for authentication.\r\nDo NOT enter your workgroup here. Leave this blank if you're using a workgroup.	<Optional>Enter, если удаленный компьютер или сетевой диск использует домен для authentication.\r\nDo не войти вашей рабочей группы. Оставьте это поле пустым, если вы используете рабочую группу.
User name	Имя пользователя
Enter the username to access the remote computer or network drive	Введите имя пользователя для доступа к удаленным компьютер или сетевой диск
Enter the password to access the remote computer or network drive	Введите пароль для доступа к удаленным компьютер или сетевой диск
Network Connection User Credentials	Учетные данные пользователя сетевого подключения
Password Mismatch	Несоответствие паролей
Passwords do not match, please reenter the passwords	Пароли не совпадают, повторите ввод паролей
Hour	Час
Minute	Минута
Wake	Пробуждение
Start	Начало
Resume	Резюме
Pause	Пауза
Stop	Остановка
Language	Язык
Pause conversion tasks	Задачи преобразования паузы
Resume conversion tasks	Резюме преобразования задачи
Please enter a valid time	Введите допустимое время
Invalid Time	Недопустимое время
Stop time is after Start time. Assuming the Stop time is during the next day, is that correct?	Время остановки — после времени начала. Предполагая, что время остановки — на следующий день, это правильно?
Time Check	Проверка времени
Only select this option if MCEBuddy has been converting your files reliably for an acceptable period of time. Do you wish MCEBuddy to delete each original file once it has been converted?	Только этот параметр если MCEBuddy преобразования файлы надежно для приемлемого периода времени. Желаете ли вы MCEBuddy для удаления каждого исходного файла после его преобразования?
Confirm delete originals?	Подтвердите удаление оригиналы?
MCEBuddy will monitor these directories for video files to convert automatically	MCEBuddy будет контролировать эти каталоги для файлов видео для преобразования автоматически
Conversion tasks	Задачи преобразования
Delete original file	Удалить оригинальный файл
Deletes the original recording after a successful conversion	Удаляет оригинальной записи после успешного преобразования
Min age before conversion (hours)	Возраст мин перед преобразованием (часы)
Minimum hours to wait before converting each file after the file is added to the queue	Минимум часа ждать перед преобразованием каждый файл после того, как файл добавляется в очередь
Use this to change the language of the text on the screen	Используется для изменения языка текста на экране
Concurrent conversions	Параллельные преобразования
Number of simultaneous conversions MCEBuddy can start\r\nNOTE: You need large amounts of free disk space and processor time for more than 2 simultaneous conversions	Число одновременных преобразований MCEBuddy можно start\r\nNOTE: вам нужно большое количество свободного дискового пространства и процессорного времени для более чем 2 одновременных преобразований
Logging level	Уровень ведения журнала
Error	Ошибка
Warning	Предупреждение
Information	Информация
Debug	Отладка
Log conversion jobs	Журнал преобразования рабочих мест
Save a log file for each conversion in the \'logs\' directory where where MCEBuddy is installed\r\n(e.g. C:\\Program Files\\MCEBuddy2x\\logs)	Сохраните файл журнала для каждого преобразования в \'logs\' каталог где, где MCEBuddy installed\r\n (например C:\\Program Files\\MCEBuddy2x\\logs)
Allow sleep	Разрешить сна
If unchecked, it prevents the system from entering sleep while converting	Если не отмечено, он предотвращает ввод сна при преобразовании
Stop at	Останавливаться на
No new conversions would be started after this time	Новые преобразования не будет запущен после этого времени
minute	минута
hour	час
If checked MCEBuddy will wake the system from sleep\r\nat the specified Start time and enabled days of the week.	Если установлен MCEBuddy разбудит системы от sleep\r\nat указанное время начала и включены дни недели.
Start at	Начало в
MCEBuddy will start new conversions between the Start and Stop time.\r\n\r\nThe Start time will be used for the enabled days of the week, whereas\r\nthe End time will be used either for the same day or\r\nfor the next day if the End time is after the Start time.	MCEBuddy будет начать новое преобразование между началом и остановить time.\r\n\r\nThe начало, время будет использоваться для включенной дней недели, whereas\r\nthe конец, время будет использоваться либо для or\r\nfor же день следующий день если время окончания после времени начала.
Delete	Удаление
Add	Добавить
Change	Изменения
Archive original file	Исходный файл архива
Domain name	Доменное имя
Stops the monitor and conversion tasks and opens a page to configure MCEBuddy	Останавливает монитор и преобразования задачи и открывает страницу для настройки MCEBuddy
Creates a folder called \'MCEBuddyArchive\' where the original file is located\r\nand moves the orginal file in this directory after a successful conversion.\r\n\r\nThis folder name and location be changed in the System Settings page.	Создает папку под названием \'MCEBuddyArchive\' где исходный файл является located\r\nand перемещает исходный файл в этой папке после успешного conversion.\r\n\r\nThis имя и расположение папки изменить на странице Параметры системы.
Debug - detailed logs, helps trace conversion problems\r\nInformation - logs basic information about conversion\r\nWarning - log potential issues or critical failures only\r\nError - log critical failures only	Отладка - подробные журналы, помогает отслеживать конверсии problems\r\nInformation - журналы основную информацию о conversion\r\nWarning - журнала потенциальные проблемы или критических сбоев only\r\nError - только критического сбоя
Select the conversion profile associated with this task. The conversion profile represents the output format and quality for the converted file.\r\nHigher quality conversions take longer to convert. Reccomended Default: MP4 High Quality or MP4 Normal.\r\n\r\nTIP: Refer to the MCEBuddy Guide for advanced parameters to tweak conversion profiles or to create your own conversion profiles	Выберите профиль преобразования, связанные с этой задачей. Профиль преобразования представляет формат вывода и качество для преобразованной file.\r\nHigher качество преобразования требуется больше времени для преобразования. Рекомендуемые по умолчанию: Высокое качество MP4 или MP4 Normal.\r\n\r\nTIP: MCEBuddy руководстве расширенные параметры для настройки профилей преобразования или для создания собственных профилей преобразования
Select the program MCEBuddy will use to strip out any commercials while converting the video.\r\nSet to 'None' to leave the commercials in the converted video.\r\n\r\nTIP: To use ShowAnalyzer instead of Comskip, please download and install ShowAnalyzer.\r\nShow Analyzer version 1.0 and greater supported.	Выберите программу, MCEBuddy будет использоваться для удаления любых рекламных роликов при преобразовании video.\r\nSet «Нет», чтобы оставить рекламу в преобразованной video.\r\n\r\nTIP: использовать ShowAnalyzer вместо Comskip, пожалуйста, скачать и установить ShowAnalyzer.\r\nShow анализатора версии 1.0 и более поддерживаются.
Used to change the video quality of the converted file, normal is 1.\r\nA higher number will improve quality but will take more time for conversion.\r\nA smaller number will reduce the quality but speed up the conversion.	Используется для изменения качество видео файле, нормальной является большее количество 1.\r\nA улучшит качество но займет больше времени на меньшее число conversion.\r\nA снижает качество но ускорить преобразование.
Enter pattern to match filenames for this task (e.g. *.wtv will convert all files ending with .wtv)\r\nPrefix pattern with ~ to skip the match (e.g. *.*;~*.wtv will process all files except those ending with .wtv)\r\nSeparate multiple patterns with ; (e.g. *.wtv;ncis*;~ncis miami*) will process all .wtv files and all files starting with ncis but not those starting with ncis miami\r\n\r\nYou can use regular expressions to match the pattern by starting with regex:	Введите шаблон для сопоставления именам файлов для этой задачи (например, *.wtv будет конвертировать все файлы с расширением с .wtv)\r\nPrefix узором с ~ пропустить матч (например *. *; ~*.wtv обработает все файлы, кроме тех, заканчивая .wtv)\r\nSeparate несколько шаблонов с; (например, *.wtv; ncis *; ~ ncis Майами *) будет обрабатывать все .wtv файлы и все файлы, начиная с ncis, но не те, начиная с ncis miami\r\n\r\nYou можно использовать регулярные выражения соответствует шаблону, начиная с regex:
Enter pattern to match show/series titles for this task (e.g. Simpson* will convert all files that have a show title starting with Simpson)\r\nPrefix pattern with ~ to skip the match (e.g. *;~Simpson* will process all show titles except those that start with Simpson)\r\nSeparate multiple patterns with ; (e.g. Simpson*;House*) or (e.g. Simpson*;NCIS*;~NCIS Miami*)\r\n\r\nYou can use regular expressions to match the pattern by starting with regex:	Введите шаблон для соответствия серии/Показать названия для этой задачи (например Симпсон * будет конвертировать все файлы, которые имеют название шоу, начиная с Симпсон) \r\nPrefix узор с ~ пропустить матч (например *; ~ Симпсон * будет обрабатывать все названия шоу, за исключением тех, которые начинаются с Симпсон) \r\nSeparate несколько моделей с; (например Симпсон *;House*) или (например Симпсон *;NCIS*; ~ NCIS Майами *) \r\n\r\nYou можно использовать регулярные выражения соответствует шаблону, начиная с regex:
This can be used to override the default Audio Language when there are multiple audio languages in a recording.\r\nTo get the list of the Audio Languages in a recording, right click on the file in the queue and select MediaInfo.\r\n\r\n<Default> will try to keep all audio tracks if supported or let the encoder choose the default audio track\r\n<Original>, if available, will use the original [non-dubbed] recording language	Это может использоваться для переопределения по умолчанию, язык аудио, когда есть несколько аудио языков в recording.\r\nTo получить список аудио языков в записи, щелкните правой кнопкой мыши на файл в очереди и выберите MediaInfo.\r\n\r\n <Default>будет пытаться сохранить все аудио треки, если поддерживается или пусть кодировщик выбрать по умолчанию аудио track\r\n <Original>, если таковые имеются, будет использовать язык оригинала [не называли] запись
Enter '[video]' or leave blank to convert all video files\r\nEnter pattern to match filenames for this location (e.g. *.wtv will convert all files ending with .wtv)\r\nPrefix pattern with ~ to skip the match (e.g. *.*;~*.wtv will process all files except those ending with .wtv)\r\nSeparate multiple patterns with ; (e.g. *.wtv;ncis*;~ncis miami*) will process all .wtv files and all files starting with ncis but not those starting with ncis miami	Введите «[видео]» или оставить поле пустым, чтобы конвертировать все видео files\r\nEnter шаблон для сравнения имен файлов для этого местоположения (например, *.wtv будет конвертировать все файлы с расширением с .wtv)\r\nprefix узором с ~ пропустить матч (например *. *; ~*.wtv будет обрабатывать все файлы, за исключением тех, заканчивая .wtv)\r\nseparate несколько шаблонов с; (например, *.wtv; ncis *; ~ ncis Майами *) будет обрабатывать все .wtv файлы и все файлы, начиная с ncis, но не те, начиная с ncis Майами
MCEBuddy Settings	MCEBuddy параметры
MCEBuddy does NOT use the currently logged in user to connect to network shares, it uses its own service account.  Be sure to specify the connection user information [MCEBuddy with a key icon]	MCEBuddy не использовать текущего пользователя для подключения к сетевым ресурсам, он использует свою собственную учетную запись службы.  Не забудьте указать данные подключения пользователя [MCEBuddy с значком ключа]
Please supply a source name	Укажите имя источника
Please supply a search path name	Укажите имя пути поиска
A source name or section	Имя источника или раздел
already exists. Please use another name	уже существует. Пожалуйста, используйте другое имя
Monitor name	Имя монитора
Give this a location a unique name	Дать это место уникальное имя
Monitor path	Монитор путь
Select the directory that MCEBuddy will monitor in the background for new video files to convert automatically	Выберите каталог, который будет контролировать MCEBuddy на заднем плане для новых видео файлов для преобразования автоматически
Click to select the folder to monitor	Щелкните, чтобы выбрать папку для мониторинга
Search pattern	Шаблон поиска
SourceForm	SourceForm
Monitor Location	Местоположение монитора
Normal	Нормальный
MCEBuddy GUI: pipeProxy engine connection error	MCEBuddy GUI: ошибка соединения двигателя pipeProxy
MCEBuddy GUI: Unable to create pipe to MCEBuddy service	MCEBuddy GUI: Не удается создать трубы MCEBuddy службе
The MCEBuddy service is unavailable. Please start from Windows control panel or check engine connection.	MCEBuddy служба недоступна. Пожалуйста начните из панели управления Windows или проверить подключение двигателя.
Announcement	Объявление
New version 	Новая версия 
available	доступные
New BETA version 	Новая бета-версия 
Click here to download new version of MCEBuddy	Нажмите здесь, чтобы скачать новую версию MCEBuddy
Click here to open link	Нажмите здесь, чтобы открыть ссылку
Idle	Холостого хода
Closing	Закрытие
MCEBuddy GUI: Unable to update tasks	MCEBuddy GUI: Не удается обновить задачи
MCEBuddy GUI: Unable to start MCEBuddy service	MCEBuddy GUI: Не удается запустить службу MCEBuddy
MCEBuddy GUI: Unable to stop MCEBuddy service	MCEBuddy GUI: Не удается остановить службу MCEBuddy
MCEBuddy GUI: Unable to cancel job	MCEBuddy GUI: Не удается отменить задание
Warning: Networked files will be accessed using the logon credentials of the MCEBuddy Service, not the currently logged on user. You can manually specify the network credentials from the Settings -> Expert Settings page in MCEBuddy.	Предупреждение: Сетевых файлов будет осуществляться с использованием учетных MCEBuddy службы, не текущего пользователя. Можно вручную задать сетевые учетные данные от параметров-> страница параметры эксперта в MCEBuddy.
Credential Warning	Предупреждение учетных данных
Status	Статус
MCEBuddy GUI: Unable to add job	MCEBuddy GUI: Не удается добавить задание
MCEBuddy GUI: Unable to get pipe active status	MCEBuddy GUI: Не удается получить статус активного канала
The conversions must be stopped to change settings. Stop the conversions?	Преобразования должны быть остановлены для изменения параметров. Остановка преобразования?
Stop Engine	Остановка двигателя
MCEBuddy GUI: Unable to stop MCEBuddy service from settings click	MCEBuddy GUI: Не удается остановить службу MCEBuddy из параметров нажмите кнопку
MCEBuddy GUI: Unable to rescan files	MCEBuddy GUI: Не удается повторить сканирование файлов
MCEBuddy GUI: Unable to open link	MCEBuddy GUI: Не удается открыть ссылку
Close	Закрыть
Close this window, MCEBuddy will keep running in the background	Закройте это окно, MCEBuddy будет держать работает в фоновом режиме
If you like MCEBuddy, please click here to Donate - THANKS	Если вам нравятся MCEBuddy, пожалуйста, нажмите здесь чтобы подарить - Спасибо
Click here to like MCEBuddy on facebook	Нажмите здесь, чтобы как MCEBuddy на facebook
Click here to open MCEBuddy website	Нажмите здесь, чтобы открыть веб-сайт MCEBuddy
Rescan	Повторное сканирование
Forces the MCEBuddy to recheck the Monitor locations for new video files to convert	Силы MCEBuddy перепроверять монитор места для новых видео файлов для преобразования
Monitor locations	Мониторинг в местах
Settings	Параметры
Select the file(s) in the queue to delete	Выберите файл(ы) в очереди для удаления
Manually add video file(s) to the queue to convert	Вручную добавьте видео файлы в очередь для преобразования
Start the MCEBuddy monitor and conversion tasks	Запуск задачи монитора и конверсии MCEBuddy
Stop the MCEBuddy monitor and conversion tasks	Остановка задачи монитора и конверсии MCEBuddy
There is a new version!	Существует новая версия!
High	Высокая
Low	Низкая
Priority	Приоритет
High priority - convert faster but may make other running applications unresponsive\r\nLow priority - convert in the background but reduced interference with other running applications	Высокий приоритет - конвертировать быстрее, но может сделать другие запущенные приложения unresponsive\r\nLow приоритетом - конвертировать в фон, но сокращение вмешательства с другими выполняющимися приложениями
A task is a conversion template that contains a conversion profile and various other conversion parameters.\r\nEach file added to the queue will be processed and converted by each of these tasks.\r\nRefer to the MCEBuddy Guide for more details on how tasks work.	Задача — это шаблон преобразования, содержащий профиль преобразования и различных других parameters.\r\nEach преобразования файлов, добавленных в очередь будут обработаны и преобразован в каждой из этих tasks.\r\nRefer в MCEBuddy руководство для получения более подробной информации о работе задачи.
Getting started	Приступая к работе
Click here for MCEBuddy guide	Нажмите здесь для MCEBuddy руководство
Logs	Журналы
Click to open log folder	Щелкните, чтобы открыть папку журнала
MCEBuddy Status	Статус MCEBuddy
add	добавить
delete	Удаление
paypal-donate	PayPal-пожертвования
stop	Остановка
OUTPUT: ConsoleOuput received NULL data	РЕЗУЛЬТАТ: ConsoleOuput получил данных NULL
hours	Часы
minutes	минут
second	второй
seconds	секунд
Starting	Начиная
Comskip advertisement scan - Pass 1	Comskip реклама сканирования - прохода 1
Comskip advertisement scan - Pass 2	Comskip реклама сканирования - пройти 2
Cutting commercials from video	Резка рекламы от видео
Cutting commercials from video - segment 	Резка рекламных роликов от видео - сегмент 
Merging commercial free segments into new video	Слияние коммерческих свободных сегментов в новое видео
Moving converted file to destination	Перемещение преобразованный файл в место назначения
Checking for disk space	Проверка наличия дискового пространства
Getting show information and banner from Internet sources	Получение шоу информация и баннер из Интернет-источников
Copying source file to working directory	Копирование исходного файла в рабочий каталог
Remuxing recording	Запись Ремультиплексирование
ShowAnalyzer advertisement scan	ShowAnalyzer реклама сканирования
Comskip advertisement scan	Comskip реклама сканирования
Analyzing video information	Анализ видео-информации
Converting	Преобразование
Removing commercials	Удаление рекламных роликов
Writing show information	Написание показать информацию
Renaming file using show information	Переименование файла с помощью показа информации
Success - All done!	Успех - все готово!
Muxing streams	Мультиплексирование потоков
Fallback remux	Резервный ремультиплексирования
Correcting audio delay	Исправление задержка звука
Converting video file - Pass 1	Конвертирование видео файла - прохода 1
Converting video file - Pass 2	Конвертирование видео файла - пройти 2
Converting video file	Конвертирование видео файла
Audio Track	Звуковой дорожки
Impaired	Нарушение
Channels	Каналы
Codec	Кодек
Video	Видео
Duration	Продолжительность
Height	Высота
Width	Ширина
Audio	Аудио
Name	Имя
Subtitle	Субтитров
Volume	Объем
Enable custom file renaming	Разрешить переименование пользовательских файлов
Enable this to enter a custom pattern to rename converted files and folders. Enter the custom pattern in the box below.\r\n\r\nExample:\r\nTVShows\%showname%\Season %season%\%showname% - S%season%##E%episode%## - %episodename% - %airyear%_%airmonth%_%airday%\r\n\r\nWill produce:\r\nTVShows\CSI\Season 1\CSI - S01E02 - Best of times - 2012_01_06.<ext>\r\n\r\nExample:\r\nRecording\%ismovie%<Movie\%showname%,TVShows\%showname%\Season %season%\%showname% - S%season%##E%episode%##>-Converted\r\n\r\nWill produce (for a movie)\r\n    Recording\Movies\Star Wars-Converted.<ext>\r\nOR (for non movies)\r\n    Recording\TVShows\CSI\Season 1\CSI - S01E02-Converted.<ext>\r\n\r\nRefer to the MCEBuddy advanced documentation for a list of all the pattern commands.	Включите это ввести пользовательский шаблон для переименования преобразованные файлы и папки. Введите пользовательский шаблон в поле below.\r\n\r\nExample:\r\nTVShows\%showname%\Season %season%\%showname% - S % сезон % ##E % эпизод % ##-% episodename % - %airyear%_%airmonth%_%airday%\r\n\r\nWill продукции: \r\nTVShows\CSI\Season 1\CSI - S01E02 - лучшие из раз - 2012_01_06.<ext>\r\n\r\nExample:\r\nRecording\%ismovie% < Movie\%showname%,TVShows\%showname%\Season %season%\%showname% - S%season%##E%episode%##>-Converted\r\n\r\nWill продуктов (для фильма) \r\n Recording\Movies\Star войн преобразованы. <ext>1\CSI \r\n Recording\TVShows\CSI\Season \r\nOR (для не фильмов) - S01E02-преобразованы.<ext>\r\n\r\nRefer для MCEBuddy передовые документации для получения списка всех команд шаблон.
ShowAnalyzer not found.\nPlease download and install ShowAnalyzer.	ShowAnalyzer не найден. \nPlease скачать и установить ShowAnalyzer.
ShowAnalyzer Missing	ShowAnalyzer отсутствует
Invalid language code, reverting to <Default> language	Недопустимый язык кода, возврат к <Default>языка
Cut start	Вырезать начало
Cut end	Вырезать конец
This specifies the number of seconds to cut from the start of the recording (BEFORE removing the ads)	Это определяет количество секунд, чтобы отрезать от начала записи (до удаления объявления)
This specifies the number of seconds to cut from the end of the recording (BEFORE removing the ads)	Это определяет количество секунд, чтобы отрезать от конца записи (до удаления объявления)
Send an eMail after each conversion.	Отправьте по электронной почте после каждого преобразования.
Send eMail	Отправить письмо
SMTP Server Name	Имя SMTP-сервера
Enter the outgoing eMail (SMTP) server address here\r\ne.g. smtp.gmail.com	Введите исходящей here\r\ne.g адреса сервера электронной почты (SMTP). SMTP.Gmail.com
Port	Порт
Enter the SMTP server port	Введите порт SMTP сервера
Use SSL	Использование SSL
Check this if you SMTP server uses SSL	Проверить это, если вы SMTP сервер использует SSL
e-Mail Settings	Параметры электронной почты
From <e-Mail>	От <e-Mail>
Enter the senders (From) eMail address here	Введите отправителей (С) адрес электронной почты здесь
To <e-Mails>	Для <e-Mails>
Enter the recipients (To) eMail address here.\r\nSeparate multiple recipients with a semicolon (;)	Введите получателей (для) электронный адрес here.\r\nSeparate множество получателей точкой с запятой (;)
Send eMail on successful conversion	Отправить письмо на успешную конверсию
Send eMail on failed conversion	Отправить по почте в Неудавшееся преобразование
Send eMail on cancelled conversion	Отправить письмо на отмененных конверсии
Send eMail on adding a conversion to the queue	Отправить письмо на добавление преобразования в очередь
Please enter a valid server address	Пожалуйста, введите адрес допустимого сервера
Invalid SMTP Server	Недопустимый SMTP-сервера
Please enter a valid server port	Пожалуйста введите действительный сервер порт
Invalid SMTP Port	Недопустимый SMTP порт
Please enter a valid From eMail address	Пожалуйста введите действительный адрес электронной почты
Invalid eMail Address	Недопустимый адрес электронной почты
Please enter valid To eMail addresses	Пожалуйста введите действительный адрес электронной почты
Username	Имя пользователя
<Optional> Enter the username for the eMail server authentication	<Optional>Введите имя пользователя для проверки подлинности сервера электронной почты
<Optional> Enter the password for the eMail server authentication	<Optional>Ввод пароля для проверки подлинности сервера электронной почты
MCEBuddy unable to download series information	Не удается загрузить информацию серии MCEBuddy
MCEBuddy successfully converted a video	MCEBuddy успешно преобразован видео
Source Video	Источник видео
Converted Video	Преобразованные видео
Converted At	Преобразован В
MCEBuddy failed to converted a video	MCEBuddy не удалось преобразовать видео
Failed At	Неудача на
MCEBuddy cancelled a video conversion	MCEBuddy отменен видео конверсии
Cancelled At	Отменено
Working	Работа
Test	Тест
Testing	Тестирование
Click this button to test the eMail server settings	Нажмите эту кнопку для тестирования параметров сервера электронной почты
MCEBuddy will send an eMail to test the server settings.\r\nThis can take upto 60 seconds.\r\nMCEBuddy may be unresponsive during this period.	MCEBuddy будет отправить по электронной почте для тестирования сервера settings.\r\nThis может принимать upto 60 seconds.\r\nMCEBuddy может быть не отвечает в течение этого периода.
Test eMail	Тестовое сообщение
MCEBuddy Test eMail	MCEBuddy тестовое сообщение
MCEBuddy - Have a great day!	MCEBuddy - есть великий день!
Send eMail test successful	Отправка электронной почты тест успешно
Send eMail test failed! Please check your settings and internet connectivity	Отправьте eMail тест не удалось! Пожалуйста, проверьте ваши настройки и подключения к Интернету
Test eMail Success	Тестовое сообщение успеха
Test eMail Failed	Тестовое сообщение не удалось
Send eMail on start of conversion	Отправить письмо на старте конверсии
MCEBuddy started a video conversion	MCEBuddy начал видео конверсии
Conversion Started At	Преобразования начались В
Yes (Comskip)	Да (Comskip)
Yes (ShowAnalyzer)	Да (ShowAnalyzer)
Atleast one Conversion Task must be enabled	Atleast одной задачи преобразования должна быть включена
Disable	Отключить
Enable	Включите
Rename	Переименование
Move	Перемещение
Up	Вверх
Down	Вниз
Slow Remuxing	Медленно Ремультиплексирование
Extracting closed captions	Извлечение закрытые подписи
Validating closed captions	Проверка закрытые подписи
Extracting subtitles	Извлечение субтитров
Trimming closed captions	Обрезка закрытые подписи
Extract subtitles and closed captions	Извлечь субтитры и скрытые субтитры
Field	Поле
Channel	Канал
Enable this to extract Closed Captions, Subtitles and Teletext from\r\nWTV, DVR-MS, TS, MP4, MKV and other supported files.\r\n\r\nIt is saved as a Subtitle (SRT) file.	Включить это, чтобы извлечь закрытые субтитры, субтитры и телетекст from\r\nWTV, DVR-MS, TS, MP4, MKV и других поддерживаемых files.\r\n\r\nIt сохраняется как файл субтитров (SRT).
Enable this to set advanced options for Closed Captions extraction\r\nField - 1 or 2\r\nChannel - 1 or 2\r\n\r\nDefault: Field 1, Channel 1	Это задать дополнительные параметры для закрытые подписи extraction\r\nField - 1 или 2\r\nChannel - 1 или 2\r\n\r\nDefault: поле 1, 1 канал
Subtitle offset	Смещение субтитров
Enter the number of seconds (+ve / -ve) to adjust the subtitles sync with video	Введите количество секунд (+ ve / - ve) для настройки синхронизации субтитров с видео
Re-ReMuxing due to audio error	Ре-ремультиплексирование аудио ошибкой
Save the poster and show information (metadata) in a MC/XBMC compatible NFO file (XML format)	Сохраните плакат и показать информацию (метаданные) в MC/XBMC совместимый NFO файл (формат XML)
Check this box to save the show information (metadata) in the converted file.\r\nThis only works for files that support metadata tags like MP4, MKV, WTV etc.\r\n\r\nNOTE: Uncheck this box if you're facing issues with some devices such as older TV's which have problem reading metadata.	Установите этот флажок для сохранения информации (метаданных), шоу в преобразованные file.\r\nThis только работает для файлов, которые поддерживают теги метаданных как MP4, MKV, WTV etc.\r\n\r\nNOTE: снимите этот флажок, если вы столкнулись с некоторыми устройствами, например старые телевизоры, которые имеют проблемы чтения метаданных вопросы.
Atleast one day of the week must be enabled	Atleast один день недели должна быть включена
Invalid Days of Week	Недопустимая дни недели
Invalid day of week found in configuration file	Неверный день недели, в файле конфигурации
Scheduling	Планирование
Remuxing to	Ремультиплексирование для
Part	Часть
Rest your mouse on any button, box or item to get Instant Help on it.\n\nFor more information on how to use, troubleshoot or get support for MCEBuddy click on the <Getting Started> link on the top right corner.\n\nDonations are always welcome :) Enjoy!\n\n  - Ramit, Derek & Goose	Остальные мыши на любую кнопку, поле или элемент получить мгновенный помочь на it.\n\nFor более подробную информацию о том, как использовать, диагностировать или получить поддержку для MCEBuddy нажмите на ссылку < начало работы настроек на верхнем правом corner.\n\nDonations всегда рады :) Наслаждайтесь! \n\n - Рамит, Дерек & гусь
Welcome to MCEBuddy	Добро пожаловать на MCEBuddy
Multichannel audio	Многоканальный звук
Check to allow multi-channel audio if the source video supports it.\r\nBy default the audio is limited to 2 channels (stereo).	Проверить, чтобы позволить многоканального звука, если исходное видео поддерживает it.\r\nBy по умолчанию аудио ограничивается 2 каналов (стерео).
Dynamic Range Compression (DRC)\r\nWhen the source is an AC3 audio, enabling DRC will\r\nreduce the difference between the loud and the soft\r\nsounds making the audio track more even.\r\nIf you have a multi-channel audio recording and you\r\nfeel the volume is too soft, checking this box might help.	Динамический диапазон сжатия (ДРК) \r\nWhen источник является AC3 аудио, позволяя ДРК will\r\nreduce разницы между громкими и soft\r\nsounds, делая звуковой дорожки больше even.\r\nIf у вас многоканальная аудио записи и you\r\nfeel, объем является слишком мягким, проверка, этот флажок может помочь.
FPS	FPS
Logfile age (days)	Logfile возраст (в днях)
Maximum number of days to keep the logfiles before deleting them.\r\nSet to 0 to keep the logs forever.	Максимальное количество дней хранения файлов журнала перед удалением them.\r\nSet 0, чтобы сохранить журналы навсегда.
DVRMS Remuxing	DVRMS Ремультиплексирование
Fast Remuxing	Быстрый Ремультиплексирование
Byte stream remuxing	Байтовый поток Ремультиплексирование
Disable cropping	Отключить обрезка
Check this to disable cropping the video automatically during conversion.\r\nCropping is used to remove the "black bars" in the video (top, bottom, left or right).\r\nUse this option if the video picture is getting cut on any side or if the final picture is looking stretched or distorted.	Проверить что это отключение обрезки видео автоматически во время conversion.\r\nCropping используется для удаления «черной полосы» в видео (сверху, снизу, слева или right).\r\nUse этот параметр, если получать вырезать видео изображение на любой стороне смотрит окончательное изображение растягивается или искажено.
Only detect Ads	Только обнаружить объявления
Check this if you want MCEBuddy to detect the ads (commercials) but NOT cut them from the video.\r\nWhen this option is enabled, MCEBuddy will create an EDL file along with the converted file that specifies the locations of ads in the converted video.\r\nAlso, for MP4, M4V and MKV files MCEBuddy will create Chapters to mark the end of commercials.	Проверьте это, если вы хотите MCEBuddy для обнаружения рекламы (рекламные ролики), но не вырезать их из video.\r\nWhen, эта опция включена, MCEBuddy создаст EDL файлов вместе с преобразованный файл, который определяет расположение объявления в преобразованном video.\r\nAlso для MP4, M4V и MKV файлы MCEBuddy будет создавать глав в ознаменование окончания рекламы.
Download information	Скачать информацию
Correction	Коррекция
Click here to correct the Show title and force use of a specific TVDB series id or IMDB movie id\r\nto lookup additional metadata from the internet.	Нажмите здесь, чтобы исправить название шоу и силу использования конкретных TVDB серии id или IMDB фильм id\r\nto поиска дополнительные метаданные из Интернета.
Check this to download additional information from the internet about the show like a banner file, episode, season etc	Проверить это, чтобы скачать дополнительную информацию из Интернета о шоу, как файл баннера, эпизод, сезона и т.д.
Profile Error	Ошибка профиля
Cannot find selected profile in profiles.conf	Не удается найти выбранный профиль в profiles.conf
Invalid Profile	Недопустимый профиль
Please select a valid profile	Пожалуйста выберите действительный профиль
The MCEBuddy Engine has crashed. Please send mcebuddy.log to the developers	MCEBuddy двигатель вышел из строя. Пожалуйста, пришлите mcebuddy.log для разработчиков
Comskip INI	Comskip INI
Select the custom Comskip INI file to use for this conversion task\r\nLeave this blank to use the default Comskip INI file for advertisement removal	Выберите Comskip INI-файл для использования для этого преобразования task\r\nLeave этот бланк для использования по умолчанию Comskip ini-файл для удаления рекламы
Click to select custom Comskip INI file	Нажмите, чтобы выбрать Comskip INI-файл
Select the folder for working with temporary files. Make sure there is enough empty space on the drive.\r\nLeave this blank to use the default temp folder in the installation folder.	Выберите папку для работы с временными файлами. Убедитесь, что имеется достаточно пустые места на drive.\r\nLeave этот пробел, чтобы использовать временную папку по умолчанию в папке установки.
Select the folder for working with temporary files. Make sure there is enough empty space on the drive.\r\nThis overrides the temp folder specified in the Settings -> Expert Settings page.	Выберите папку для работы с временными файлами. Убедитесь, что достаточно пустого места на drive.\r\nThis переопределяет temp папке, указанной в настройках-> эксперт параметры страницы.
Click to select temp working folder	Нажмите, чтобы выбрать временной рабочей папки
Temp folder	Временный каталог
Space check	Проверка пространства
When enabled MCEBuddy will check for enough free space for the conversion (destination and temp).\r\nUncheck this if you have are having trouble with network drives or have extraordinarily large video files.	Когда включен MCEBuddy будет проверять наличие достаточно свободного места для преобразования (назначения и temp).\r\nUncheck если у вас есть вот имея проблемы с сетевых дисков или имеют чрезвычайно больших видео файлов.
MCEBuddy Windows Event Logs	Журналы событий MCEBuddy Windows
Events	События
Click here to open the MCEBuddy Windows Event Logs	Нажмите здесь, чтобы открыть журналы событий Windows MCEBuddy
Enable UPnP	Включить UPnP
Check this to enable UPnP. This allows access to MCEBuddy engine from outside the network.\r\nThis needs to be checked if you're using a mobile/standalone MCEBuddy client to access MCEBuddy.	Установите флажок, чтобы включить UPnP. Это позволяет доступ к MCEBuddy двигатель от за пределами network.\r\nThis необходимо проверить, если вы используете мобильный/автономный MCEBuddy клиент для доступа к MCEBuddy.
Click here to connect to another MCEBuddy engine	Нажмите здесь, чтобы подключиться к другой MCEBuddy двигатель
MCEBuddy Remote Engine Connection	MCEBuddy удаленного подключения двигателя
Engine Name	Название двигателя
Engine Port	Порт двигателя
Enter the Name or IP Address of the MCEBuddy engine you want to connect to	Введите имя или IP-адрес MCEBuddy двигатель, который вы хотите подключить к
Enter the TCP Port number of the MCEBuddy Engine you want to connect to	Введите номер порта TCP, MCEBuddy двигателя, вы хотите подключиться к
Enter the TCP Port number of the MCEBuddy Engine you want to connect to (1 to 63355)	Введите номер порта TCP, MCEBuddy двигателя, вы хотите подключиться к (1 63355)
Invalid Name/Port	Недопустимое имя/порт
Please enter a valid Engine Name and Engine Port Number	Пожалуйста, введите действительный двигатель имя и номер порта двигателя
Error Stopping Engine	Ошибка остановки двигателя
Unable to stop MCEBuddy engine, settings may not be saved. Do you want to continue?	Не удается остановить двигатель MCEBuddy, параметры могут не быть сохранены. Вы хотите продолжить?
Unable to communicate with engine. Settings have NOT been saved.	Не удается связаться с двигателем. Параметры не были сохранены.
Communication Error	Ошибка связи
Engine not stopped. Settings have NOT been saved.	Двигатель не остановился. Параметры не были сохранены.
Unable To Save Settings	Не удалось сохранить параметры
Unable to communicate with engine. UPnP settings have not been updated	Не удается связаться с двигателем. Не были обновлены настройки UPnP
Audio delay	Задержка звука
Enter a value in seconds (positive or negative) here to shift the audio relative to the video.\r\nUse this to resync the audio with the video, if they are out of sync after conversion.\r\nA positive value will delay the audio (i.e. video ahead of audio) and a negative value will advanced the audio (i.e. audio ahead of video).\r\nE.g. -1.5	Введите значение в секундах (положительный или отрицательный) здесь сдвиг аудио по отношению к video.\r\nUse, чтобы синхронизировать аудио с видео, если они не синхронизированы после conversion.\r\nA это положительное значение задержит аудио (то есть видео впереди аудио) и отрицательное значение будет расширенный аудио (то есть аудио впереди video).\r\nE.g. -1,5
Media info	Информация для СМИ
Click here to get media properties for selected files	Нажмите здесь, чтобы получить СМИ свойств для выбранных файлов
Save information	Сохранение информации
Add information	Добавить информацию
Shows a preview of the custom filename and path	Показывает предварительный просмотр пользовательских имя файла и путь
Invalid Filename Pattern	Недопустимый шаблон имени файла
TVDB Series ID	TVDB серии ID
IMDB Series ID	IMDB серии ID
Original title	Оригинальное название
Corrected title	Исправлены название
Enter the TVDB Series ID you want to use for downloading show information.\r\nIf the Original title box is empty, this will be applied to all shows selected by this conversion task.	Введите ID серии TVDB, вы хотите использовать для загрузки шоу information.\r\nIf в оригинальную коробку название пуст, это будет применяться ко всем показывает, выбран в данной задаче преобразования.
Enter the IMDB Movie ID you want to use for downloading movie information.\r\nIf the Original title box is empty, this will be applied to all shows selected by this conversion task.	Введите идентификатор IMDB фильм, вы хотите использовать для скачивания фильма information.\r\nIf оригинал поле Название пуст, это будет применяться ко всем показывает, выбран в данной задаче преобразования.
Internet Lookup Title and Metadata Correction	Интернет Поиск Название и коррекция метаданных
Click here to add another row to match and correct titles and series id.\r\nIf you want to use the same corrected title or series id for all shows converted by this conversion task,\r\nleave the original title blank on the first row and you should NOT add a second row.	Нажмите здесь, чтобы добавить другую строку в матч и корректировке названий и серии id.\r\nIf вы хотите использовать же исправлены название или серии id для всех шоу, преобразованы в данной задаче преобразования \r\nleave Оригинальный заголовок пустым на первой строке и вы не следует добавлять вторую строку.
Enter pattern to match show/series titles for correction (e.g. Simpson* will replace all titles that have a show title starting with Simpson)\r\nPrefix pattern with ~ to skip the match (e.g. *.*;~Simpson* will correct all show titles except those that start with Simpson)\r\nSeparate multiple patterns with ; (e.g. Simpson*;House*) or (e.g. Simpson*;NCIS*;~NCIS Miami*)\r\n\r\nNOTE: Leave this box empty if you want to apply the corrected title or series id to ALL files being processed by this conversion task.\r\nIf leaving blank, you cannot add a second row.\r\n\r\nYou can use a regular expression to match the title by starting with regex:	Введите шаблон для соответствия серии/Показать названия для коррекции (например Симпсон * будет заменить все титулы, которые имеют название шоу, начиная с Симпсон) \r\nPrefix узор с ~ пропустить матч (например *. *; ~ Симпсон * исправит все Выставочные титулы, за исключением тех, которые начинаются с Симпсон) \r\nSeparate несколько моделей с; (например Симпсон *;House*) или (например Симпсон *;NCIS*; ~ NCIS Майами *) \r\n\r\nNOTE: оставить это поле пустым, если вы хотите применить исправленное название или серии id для всех файлов, обрабатываемых этой конверсии task.\r\nIf оставив пустым, нельзя добавить второй row.\r\n\r\nYou можно использовать регулярное выражение соответствует название, начиная с regex:
Enter the new/corrected title you want to use for downloading additional information from the internet.\r\nIf the Original title box is empty, this will be applied to all shows selected by this conversion task.\r\n\r\nYou can use a regular expression to correct the title by starting with regex:	Введите название нового/исправления, вы хотите использовать для загрузки дополнительной информации от internet.\r\nIf оригинал название поле является пустым, это будет применяться для всех шоу, выбранных путем преобразования task.\r\n\r\nYou можно использовать регулярное выражение исправить название, начиная с regex:
For each row, please enter the Original title to match the show name AND either a Corrected title or a TVDB/IMDB Series ID	Для каждой строки, введите пожалуйста оригинальное название для соответствия Показать имя и либо исправленное название или идентификатор серии TVDB/IMDB
Please enter either a Corrected title or a TVDB/IMDB Series ID	Пожалуйста, введите правильный заголовок или ID серии TVDB/IMDB
Enable this if you want MCEBuddy to put the converted file in the source directory\r\nif the destination path is unavailable. (e.g. Network failure or mapping failure)	Включить это, если вы хотите MCEBuddy поставить преобразованный файл в источник directory\r\nif путь назначения недоступен. (например, сети сбоя или отказа карт)
Fallback to source path	Возврат исходного пути
Used to increase or decrease the volume of the\r\nrecording while converting.\r\n1 is normal, anything below will reduce it, anything\r\nhigher will increase it.	Используется для увеличения или уменьшения громкости the\r\nrecording, в то время как converting.\r\n1 это нормально, все, что ниже будут уменьшить его, anything\r\nhigher увеличит его.
Archive folder	Папка архива
Change the location of the archive folder.\r\nLeave empty to use the default 'MCEBuddyArchive' folder in the original directory.	Измените расположение архива folder.\r\nLeave пустым для использования по умолчанию папка «MCEBuddyArchive» в исходном каталоге.
Monitor subdirectories	Монитор подкаталоги
Check this box to also monitor all directories within the Monitor path	Установите этот флажок для также контролировать все каталоги в пути монитор
Click here to show MCEBuddy status	Нажмите здесь, чтобы показать статус MCEBuddy
MCEBuddy service not connected	Служба MCEBuddy не подключен
MCEBuddy idle	MCEBuddy простоя
conversions in progress	преобразования в прогресс
MCEBuddy stopped	MCEBuddy остановлен
Sync converted files	Синхронизация преобразованных файлов
Check this option if you want MCEBuddy to keep the converted files in sync with the original files.\r\ni.e. When the original files are deleted by the user, the corresponding converted files are also deleted.\r\n\r\nNOTE: MCEBuddy only monitors original files in the monitor locations folders and ONLY while the engine is running.\r\nMCEBuddy will not be able to track user deleted files while the engine is stopped.	Установите этот флажок, если вы хотите MCEBuddy сохранить преобразованные файлы в синхронизации с оригинальной files.\r\ni.e. Если исходные файлы удалены пользователем, соответствующие преобразованные файлы также являются deleted.\r\n\r\nNOTE: MCEBuddy только следит за оригинальные файлы в папках расположения монитор и только пока двигатель running.\r\nMCEBuddy не сможет отслеживать файлы пользователь удален во время остановки двигателя.
Do you wish MCEBuddy to delete each converted file when the original file has been deleted?	Желаете ли вы MCEBuddy для удаления каждый преобразованный файл, когда исходный файл был удален?
Confirm sync conversions?	Подтверждение преобразования sync?
Are you sure you DO NOT want to remove commercials from the converted video and only keep the EDL file?	Вы уверены, что вы не хотите удалить ролики из преобразованного видео и только сохранить EDL файлов?
ShowAnalyzer is not responding. Please the reboot system or reinstall ShowAnalyzer.	ShowAnalyzer не отвечает. Пожалуйста, перезагрузки системы или переустановить ShowAnalyzer.
ShowAnalyzer Not Responding	ShowAnalyzer не отвечает
Make sure you press 'Start' after closing this window, otherwise Scheduling and Wake will not work.	Убедитесь, что вы нажмите кнопку «Start» после закрытия этого окна, в противном случае планирования и звонок не будет работать.
Enabling Scheduling and Wake	Благоприятных планирование и звонок
Passwords do not match	Пароли не совпадают
Password error	Ошибка пароль
Adding subtitles and chapters to file	Добавление субтитров и глав в файл
Send eMail if unable to download series information	Напишите, если не удается загрузить серии информации
Check this box if you want this conversion task to only process files from specific monitor locations.\r\nIf unchecked each conversion task will process files from all monitor locations (including new ones added later).	Установите этот флажок, если вы хотите эту задачу преобразования, чтобы обрабатывать только файлы из конкретных монитор locations.\r\nIf снят каждой задачи преобразования будет обрабатывать файлы из всех мест монитор (в том числе новые добавлены позже).
Select Monitor Locations	Выберите монитор места
Select atleast one Monitor Location name	Выберите atleast один монитор местоположение имя
You have selected all the current Monitor Locations.\r\nDo you want this conversion task to automatically process any new Monitor Locations added in future?	Вы выбрали все текущие Locations.\r\nDo монитор преобразования задачи для автоматической обработки любых новых местах монитор, добавлены в будущем?
New monitor locations	Новые места монитор
Invalid selection	Недопустимый выбор
Channel name match	Матч имя канала
Enter pattern to match the channel name for this task (e.g. ABC* will convert all files that recorded on a channel name starting with ABC)\r\nPrefix pattern with ~ to skip the match (e.g. *;~ABC* will process all channels except those that start with ABC)\r\nSeparate multiple patterns with ; (e.g. ABC*;TBS*) or (e.g. ABC*;Fox*;~Fox4*)\r\n\r\nYou can use regular expressions to match the pattern by starting with regex:	Введите шаблон в соответствии с именем канала для этой задачи (например, ABC * будет конвертировать все файлы, которые записаны на имя канала начиная с ABC) \r\nPrefix узор с ~ пропустить матч (например *; ~ ABC * будет обрабатывать все каналы, за исключением тех, которые начинаются с ABC) \r\nSeparate несколько моделей с; (например ABC *;TBS*) или (например ABC *;Fox*; ~ Fox4 *) \r\n\r\nYou можно использовать регулярные выражения соответствует шаблону, начиная с regex:
Clear history	Очистить историю
Click this button to clear the history of all converted files.\r\nThis is cause MCEBuddy to reconvert all files being monitored.	Нажмите эту кнопку, чтобы очистить историю всех преобразованных files.\r\nThis является причиной MCEBuddy для повторного преобразования всех файлов под контролем.
Are you sure you want to clear the history of all conversions?\r\nThis will cause MCEBuddy to reconvert all files being monitored.	Вы уверены, что хотите очистить историю всех преобразований? \r\nThis приведет к MCEBuddy для повторного преобразования всех файлов под контролем.
Show history	Показать историю
Click this button to show the history of all converted files.	Нажмите эту кнопку, чтобы показать историю всех преобразованных файлов.
History of Converted Files	История преобразованных файлов
Unable to communicate with engine.	Не удается связаться с двигателем.
Extracting streams	Извлечение потоков
Fallback muxing streams	Резервный мультиплексирования потоков
Remuxing TiVO file	TiVO Ремультиплексирование файла
Enter your 10 digit TiVO MAK key to convert and process TiVO recordings	Введите свой 10-значный ключ TiVO MAK для преобразования и обработки записи TiVO
Invalid TiVO MAK Key	Недопустимый ключ TiVO
The TiVO MAK key should be 10 digits	Ключ TiVO MAK должно быть 10 цифр
Version mismatch. Please ensure that the MCEBuddy client and engine are running the same version.	Несоответствие версий. Пожалуйста, убедитесь, что клиент MCEBuddy и двигатель выполняются той же версии.
Error retrieving Event Logs	Ошибка при получении журналы событий
Unable to get Event Log Entries from the MCEBuddy engine.	Не удается получить записи журнала событий от двигателя MCEBuddy.
PAUSED: Check conversion schedule	ПРИОСТАНОВЛЕНО: Проверка преобразования расписание
Logging	Ведение журнала
Folder Management	Управление папками
Processor Management	Управление процессора
Expert Settings	Настройки для экспертов
System Settings	Параметры системы
Click here to change additional settings (for experts only)	Нажмите здесь, чтобы изменить дополнительные параметры (для специалистов)
Failed folder	Ошибка папки
Location of the folder that hold the original files for failed conversions.	Расположение папки, которые держат исходные файлы для сбой преобразования.
Move original file on failure	Переместите исходный файл на провал
Check this to move the original file to a separate folder if the conversion fails.	Проверите это, чтобы переместить исходный файл в отдельную папку, если преобразование завершается неудачей.
Check this to limit the number of logical processors that MCEBuddycan use.\r\nEach check box below corresponds to an available logical processor.	Установите флажок ограничить число логических процессоров, которые MCEBuddycan use.\r\nEach флажок ниже соответствует доступных логических процессоров.
Each box represents logical processors from 1 to 16 respectively.\r\nChecking a box allows MCEBuddy to use that processor.	Каждое поле представляет процессоров от 1 до 16 respectively.\r\nChecking коробку позволяет MCEBuddy использовать процессор.
Each box represents logical processors from 17 to 32 respectively.\r\nChecking a box allows MCEBuddy to use that processor.	Каждый флажок представляет логических процессора от 17 32 respectively.\r\nChecking ящик позволяет MCEBuddy использовать процессор.
Select atleast one processor to use	Выберите один процессор atleast для использования
Invalid Configuration	Недопустимая конфигурация
Comskip path	Comskip путь
If you want to use a custom version of Comkip (e.g. donator version)\r\nthen enter the path of the comskip installation here.\r\nLeave blank to use the default comskip that comes with MCEBuddy.	Если вы хотите использовать пользовательскую версию Comkip (например даритель версия) \r\nthen введите путь comskip установки here.\r\nLeave пустым, чтобы использовать comskip по умолчанию, которая поставляется с MCEBuddy.
Miscellaneous	Прочее
Ignore copy protection	Игнорировать защиты от копирования
Check this to ignore the copy protection flag on video file while converting.\r\nNOTE: MCEBuddy cannot bypass encryption, this only helps if a file is incorrectly\r\ntagged as copy protected when it is NOT encrypted.	Проверить это игнорировать флаг защиты от копирования на видео файла во время converting.\r\nNOTE: MCEBuddy не может обойти шифрование, это только помогает, если файл incorrectly\r\ntagged как копирование, защиту, когда он не зашифрован.
Use recycle bin	Использование корзины
Check this to use the recycle bin when files are deleted by MCEBuddy	Проверить это использовать корзины, когда файлы будут удалены по MCEBuddy
Poll period	Период опроса
This is how often MCEBuddy scans the Monitor Tasks Locations for new files.\r\nThe interval is specified in seconds.	Это, как часто MCEBuddy сканирование мест задачи монитора для новых files.\r\nThe интервал задается в секундах.
Server port	Порт сервера
This is the TCP port MCEBuddy uses to communicate with the remote engine.\r\nWhen UPnP is enabled, MCEBuddy will automatically add this port to the Windows Firewall\r\nand UPnP gateway to allow access from the internet on this port.	Это TCP-порт, который MCEBuddy использует для взаимодействия с удаленной engine.\r\nWhen UPnP включена, MCEBuddy автоматически добавит этот порт на шлюз Windows Firewall\r\nand UPnP, чтобы разрешить доступ из Интернета на этот порт.
Hang period	Висят период
Enter the number of seconds that MCEBuddy will wait for a response from the\r\nunderlying application before terminates the application as hung.\r\nEnter 0 to disable hang detection.	Введите количество секунд, MCEBuddy будет ждать ответа от the\r\nunderlying приложения перед завершает приложение как hung.\r\nEnter 0 для отключения обнаружения повесить.
Subtitle commercial cut sync	Коммерческие субтитров, вырезать sync
This parameter is used when the subtitles go progressively out of sync after each commercial segment is removed from the video.\r\nThis setting is used to bring the subtitles back into sync with the video.\r\nEach time the video commercial is cut out, the subtitles are time shifted by this amount (+ve or -ve in seconds).	Этот параметр используется, когда идти постепенно синхронизированы после каждого коммерческого сегмента удаляется от параметра video.\r\nThis используется для приведения субтитры субтитры обратно в sync с video.\r\nEach время вырезают коммерческие видео, субтитры время сдвинуто на этой суммы (+ ve или - ve в секундах).
Invalid poll period	Недопустимый опрос период
Invalid server port	Недопустимый сервер порт
eMail Subject Customization	Тема настройки электронной почты
Use this section to customize the subject of eMail sent by MCEBuddy on the various conversion events listed below.\r\nRefer to the documentation, custom commands for user defined variables.\r\ne.g. Show %showname% for file %originalfilename% conversion successful using task %taskname%\r\nNOTE: Not always will all the data be available in the custom commands.\r\nLeave blank to use default subject lines.	Использовать этот раздел, чтобы настроить тему электронной почты отправлено MCEBuddy на различные события преобразования перечисленных below.\r\nRefer документации, пользовательские команды для определяемых пользователем variables.\r\ne.g. Показать showname % для файла % originalfilename % конверсии успешным с помощью задачи % taskname%\r\nNOTE: не всегда все данные будут доступны в пользовательской commands.\r\nLeave пустым, чтобы использовать по умолчанию сюжетные линии.
Success	Успех
Failed	Не удалось
Cancelled	Отменено
Download fail	Скачать fail
Limit processor utilization	Ограничение использования процессора
Check this to limit the number of logical processors that MCEBuddy can use.\r\nEach check box below corresponds to an available logical processor.	Проверить это ограничить количество логических процессоров, что MCEBuddy может use.\r\nEach флажок ниже соответствует доступных логических процессоров.
Custom profile	Пользовательский профиль
If you have a custom profiles.conf file that you want to use instead of the\r\none that comes with MCEBuddy, enter the path to the file here.\r\n\r\nNOTE: MCEBuddy constantly updates profiles.conf to provide bug fixes,\r\nenhancements and performance improvements which you will miss out\r\non if you use this feature.	Если у вас есть пользовательский profiles.conf файл, который вы хотите использовать вместо the\r\none, что происходит с MCEBuddy, введите путь к файлу here.\r\n\r\nNOTE: MCEBuddy постоянно обновления profiles.conf предоставлять ошибка исправления, \r\nenhancements и производительности работы программы, которые вам будет не хватать out\r\non, если вы используете эту функцию.
Invalid custom profiles.conf	Недопустимый пользовательский profiles.conf
Suspend on battery	Приостановить на батарее
Suspend conversions when the computer switches to battery power	Приостановить преобразования, когда компьютер переключается на питание от батареи
MCEBuddy added a video conversion to the queue	MCEBuddy добавил видео конверсии в очередь
Queue	Очередь
Refer to documentation on using custom commands in custom eMail subjects	Обратитесь к документации по использованию пользовательских команд в пользовательских eMail предметам
Could not copy information to Clipboard, please try again.	Не могут копировать информацию в буфер обмена, повторите попытку.
Error copying to Clipboard	Ошибка при копировании в буфер обмена
Copy to clipboard	Копировать в буфер
Reconvert files	Преобразовать файлов
Are you sure you want to reconvert the selected files?	Вы уверены, что вы хотите преобразовать выбранные файлы?
Select the files you want to reconvert and then click this button.\r\nIf the original files are still being monitored by MCEBuddy they will be queued for reconversion.	Выберите файлы, которые вы хотите преобразовать и нажмите этот button.\r\nIf, оригинальные файлы отслеживаются по-прежнему MCEBuddy, они будут поставлены в очередь для повторного преобразования.
Time taken to convert	Время, необходимое для преобразования
Network authentication	Проверка подлинности сети
Click the button to enter the network shares credentials.\r\nThis authentication is used when files are added via the Add button on the main window\r\nor dragged and dropped from a network share into the conversion status box on the main window.	Нажмите кнопку, чтобы войти сетевой акций credentials.\r\nThis аутентификации используется при добавлении файлов через на главной window\r\nor кнопку Добавить перетаскивать из сетевой папки в поле состояние преобразования на главном окне.
Skip reconversion	Пропустить реконверсии
Do not reconvert the video if a converted file already exists in the destination directory.	Не преобразовывать видео, если преобразованный файл уже существует в каталоге назначения.
The expected filename for the converted video (not the original video filename) is compared with the filenames in the destination directory.\r\nIf the converted file exists, the file will not be reconverted and it will be assumed to be a successful conversion.\r\nThis is useful if the same show/episode is being recorded on multiple times and you don't want to reconvert them.\r\n\r\nNOTE: This option is ignored for videos that are added manually using the add button or dragging and dropping	Ожидаемое имя файла для преобразованные видео (не оригинальные видео файла) по сравнению с именами файлов в directory.\r\nIf назначения преобразованный файл существует, файл будет не трансформируются и будет предположить, чтобы быть успешным conversion.\r\nThis является полезным, если же шоу/эпизод записывается на несколько раз, и вы не хотите преобразовать them.\r\n\r\nNOTE: Этот параметр игнорируется для видео, которые были добавлены вручную с помощью кнопки Добавить или перетаскивания
If enabled, skip reconversion will also check the history file for past conversions.\r\nThe expected filename for the converted video (not the original video filename) is compared with the filenames in the history file.\r\nIf the to be converted filename (including path) matches any of the already converted filenames (including paths) in the history file,\r\nthe file will not be reconverted and it will be assumed to be a successful conversion.	Если этот параметр включен, скип реконверсии будет также проверять файл истории прошлых conversions.\r\nThe предполагается, что имя файла для преобразованные видео (не оригинальные видео файла) сравнивается с именами файлов в истории file.\r\nIf быть преобразованное имя файла (включая путь) соответствует любому из уже освоенных имена файлов (включая пути) в файл истории, файл \r\nthe не быть переделаны и он будет считаться успешной конверсии.
Adding file to the iTunes library	Добавление файла в библиотеку iTunes
Add to iTunes	Добавить в iTunes
Check this box to automatically add the converted files to the iTunes library.\r\nThis only works with iTunes supported files (e.g. MP4, M4V, MP3 etc)	Установите этот флажок, чтобы автоматически добавить преобразованные файлы в iTunes library.\r\nThis работает только с iTunes поддерживает файлы (например, MP4, M4V, MP3 и т.д.)
Adding file to the WMP library	Добавление файла в библиотеку WMP
Library Management	Управление библиотекой
Add to Windows Media Player	Добавить в проигрывателе Windows Media
Check this box to automatically add the converted files to the WMP library.	Установите этот флажок, чтобы автоматически добавить преобразованные файлы в библиотеку WMP.
Renaming and Sorting	Переименование и сортировка
Selection Filters	Фильтры выбора
Audio and Video	Аудио и видео
Subtitles and Chapters	Субтитры и глав
Skip copying original files	Пропустить копирование исходных файлов
CHECK THIS BOX AT YOUR OWN RISK.\r\nDO NOT CHECK THIS BOX UNLESS YOU KNOW WHAT YOU ARE DOING.\r\nCheck this box to skip making a backup of original file (copying) while converting.	ПРОВЕРИТЬ это поле на свой собственный RISK.\r\nDO не проверить это поле Если вы знаете, что ты DOING.\r\nCheck этот флажок Пропустить сделать резервную копию оригинального файла (копирование) во время преобразования.
CHECK THIS BOX AT YOUR OWN RISK.\r\nDO NOT CHECK THIS BOX UNLESS YOU KNOW WHAT YOU ARE DOING.\r\nCheck this box to skip making a backup of original file (copying) while converting.\r\nIf this is checked, the original file will not be preserved in case of an error.\r\nIt can also even lead to conversion failures or other unforeseen conversion issues.	ПРОВЕРИТЬ это поле на свой собственный RISK.\r\nDO не этот флажок Если вы не знаете, что вы есть DOING.\r\nCheck установлен этот флажок, чтобы пропустить сделать резервную копию оригинального файла (копирование) во время converting.\r\nIf это, исходный файл не будет сохранена в случае error.\r\nIt и даже может привести к ошибок преобразования или других вопросов, непредвиденных преобразования.
Are you sure you want to do this?	Вы уверены, что вы хотите это сделать?
Media Information Management	Управления информацией средств массовой информации
Force show type	Силы Показать тип
Set this to force treating the video recording as a Movie or TV Series.\r\nThis will change the way additional information (metadata) about the recording is downloaded from the internet.\r\nMovie - Treat the recording as movie\r\nSeries - Treat the recording as a TV Series\r\nSports - Treat the recording as a Sports show\r\nDefault - Use the default information available in the recording metadata to determine Movie or TV Series	Установите это для принудительного лечения видеозапись как фильм или ТВ Series.\r\nThis изменит способ дополнительную информацию (метаданные) о записи загружается с internet.\r\nMovie лечить - лечить запись как movie\r\nSeries - лечить запись как Series\r\nSports ТВ - запись как спорт show\r\nDefault - использовать информацию по умолчанию, доступны в записи метаданных для определения фильм или сериал
Show type	Показать тип
Select this to filter the type of recordings being converted.\r\n\r\nMovies - select this to convert if the show type is Movie.\r\nShows - select this to convert if the show type is NOT a Movie.\r\nSports - select this to convert if the show type is Sports.\r\n\r\nNOTE: Show type is read from the recording metadata.\r\nOnly some recordings support show type metadata such as WTV and\r\nrecordings with supporting metadata files (XML/ARG etc).	Выберите этот параметр для фильтрации типа записей, будучи converted.\r\n\r\nMovies - выбирите это, чтобы преобразовывать если тип шоу Movie.\r\nShows - выбирите это, чтобы преобразовать, если тип шоу не является Movie.\r\nSports - выберите этот пункт для преобразования если тип шоу Sports.\r\n\r\nNOTE: Показать тип считывается из записи metadata.\r\nOnly поддерживают некоторые записи шоу типа метаданных, таких как WTV and\r\nrecordings с поддержкой метаданных файлов ()XML/ARG и т.д.).
This box shows all the files in queue for conversion.\r\nDrag and drop files here or press the Add button to add files to the conversion queue	Это поле показывает все файлы в очереди для conversion.\r\nDrag и drop файлов или нажмите кнопку Добавить, чтобы добавить файлы в очередь преобразования
Conversion	Преобразования
Files	Файлы
Click this button to open or close the Advanced Settings section	Нажмите эту кнопку, чтобы открыть или закрыть раздел Дополнительные параметры
Running custom commands	Выполнение пользовательских команд
Trimming video recording	Обрезка видео записи
Insert at top of queue	Вставить в верхней части очереди
By default, new conversions are added to the bottom (end) of the conversion queue.\r\nIf this box is checked, any new conversions added by this task will be added to the\r\nbeginning (top) of the conversion queue.	По умолчанию новые преобразования добавляются к нижней (конец) преобразования queue.\r\nIf этот флажок установлен, любые новые преобразования, добавил этой задачи будут добавлены к the\r\nbeginning (вверху) очереди преобразования.
Add subtitles and chapters	Добавить субтитры и глав
Enable this option to add any extracted subtitles and chapters to the converted video.\r\nEach chapter marks the end of a commercial. This only works with supported formats (e.g. MKV, MP4).\r\n\r\nNOTE: Some players and older TV's don't support embedded subtitles and chapters.\r\nIf you're unable to playback the converted video's, try turning this option off.	Включите этот параметр, чтобы добавить любые извлеченные субтитры и глав для главе преобразованного video.\r\nEach знаменует собой конец коммерческой. Это работает только с поддерживаемыми форматами (например, MKV, MP4).\r\n\r\nNOTE: некоторые игроки и старые телевизоры не поддерживают встроенные субтитры и chapters.\r\nIf вы не в состоянии воспроизведения конвертировать видео, попробуйте отключить этот параметр.
Select best soundtrack	Выберите лучший саундтрек
If the original video has multiple soundtracks, this option tells MCEBuddy to select the most appropriate and primary soundtrack.\r\nIf you want a specific language soundtrack, make sure you enter the language name or code in the Audio Language box.\r\nCheck this box if you're hearing the wrong soundtrack in your converted file.\r\n\r\nUncheck this box if you want MCEBuddy to retain all the soundtracks from the original video in the converted file when possible.\r\nNOTE:Some profiles do not support multiple soundtracks, in which case this setting has no effect.	Если исходное видео имеет несколько саундтреков к фильмам, этот параметр говорит MCEBuddy для выбора наиболее подходящих и первичной soundtrack.\r\nIf вы хотите конкретного языка саундтрек, убедитесь, что вы вводите имя языка или код в язык аудио box.\r\nCheck это поле, если вы слышите неправильно саундтрек в преобразованной file.\r\n\r\nUncheck галочку, если вы хотите MCEBuddy сохранить все саундтреки из оригинального видео в преобразованном файле, когда это возможно. \r\nNOTE: некоторые профили не поддерживают несколько саундтреков к фильмам, в этом случае этот параметр не влияет.
Enable remote access	Включить удаленный доступ
This creates an exception in the windows firewall for MCEBuddy application and the port.\r\nThis is required if you have windows firewall enabled and want to use UPnP, the remote client\r\nor access the engine using an IP address.\r\n\r\nNOTE: If you have a custom firewall, this may not work, you will need to manually create an\r\nexception for MCEBuddy service and the port.	Это создает исключение в брандмауэре windows для приложения, MCEBuddy и port.\r\nThis не требуется, если брандмауэр windows включен и хотите использовать UPnP, доступ удаленного client\r\nor двигателя, с использованием IP address.\r\n\r\nNOTE: если у вас есть настраиваемый брандмауэр, это может не работать, вам нужно будет вручную создать an\r\nexception для службы MCEBuddy и порт.
Unable to communicate with engine. Firewall exception settings have not been updated.	Не удается связаться с двигателем. Параметры исключения брандмауэра не были обновлены.
Detect and optimize video quality	Определять и оптимизировать качество видео
When enabled, MCEBuddy will optimize the video processing options by trying to detect the video source type.\r\nThis can improve the quality of the converted video significantly if correctly detected.\r\n\r\nNOTE: It does this by trying to detect the video source type (interlaced, progressive or telecine).\r\nIf it is able to detect the video source type, it will override the corresponding parameters in the profile.\r\nTurn this option off if you are facing issues with converted video quality or want to use the default profile parameters.	Когда включен, MCEBuddy будет оптимизировать параметры обработки видео, пытаясь обнаружить источник видео type.\r\nThis может улучшить качество преобразованного видео значительно, если правильно detected.\r\n\r\nNOTE: он делает это, пытаясь обнаружить тип видео источника (чересстрочной, прогрессивной или telecine).\r\nIf способен обнаружить тип видео источника, переопределяют соответствующие параметры в profile.\r\nTurn этот параметр off, если вы столкнулись с проблемами с качеством преобразованные видео или хотите использовать параметры профиля по умолчанию.
Are you sure you want to delete this task?	Вы уверены, что вы хотите удалить эту задачу?
Delete Task	Удаление задачи
Enter the new task name	Введите имя новой задачи
Rename Task	Переименование задачи
MCEBuddy PAUSED	MCEBuddy приостановлена
idle	простоя
PAUSED	ПРИОСТАНОВЛЕНА
Frame rate	Частота кадров
Enable this to set a custom framerate (FPS) for the converted video.\r\nYou may need to set this while converting video formats (e.g. PAL to NTSC)\r\nor for devices which support only specific framerates.\r\n\r\nE.g.: 25\r\nE.g.: 30000/1001	Это установить пользовательские частоты кадров (FPS) для преобразованных video.\r\nYou может потребоваться установить это во время преобразования видео форматов (например, PAL в NTSC) \r\nor для устройств, которые поддерживают только в определенных framerates.\r\n\r\nE.g.: 25\r\nE.g.: 30000/1001
Skip remuxing files	Пропускать файлы Ремультиплексирование
CHECK THIS BOX AT YOUR OWN RISK.\r\nDO NOT CHECK THIS BOX UNLESS YOU KNOW WHAT YOU ARE DOING.\r\nCheck this box to skip remuxing the original file to a TS file while converting.\r\nIf this is checked, some functions like subtitle extraction or comskip may not work.\r\nIt can also even lead to conversion failures or other unforeseen conversion issues.	Проверьте этот ящик на свой собственный RISK.\r\nDO не установите это флажок, если вы знаете, что ты DOING.\r\nCheck этот флажок Пропустить Ремультиплексирование исходный файл в файл TS во время converting.\r\nIf это проверяется, некоторые функции, такие как извлечение субтитров или comskip может не work.\r\nIt и даже может привести к ошибок преобразования или других вопросов, непредвиденных преобразования.
CHECK THIS BOX AT YOUR OWN RISK.\r\nDO NOT CHECK THIS BOX UNLESS YOU KNOW WHAT YOU ARE DOING.\r\nCheck this box to skip remuxing the original file to a TS file while converting.	Проверьте этот ящик на свой собственный RISK.\r\nDO не проверить это поле Если вы знаете что ты DOING.\r\nCheck этот флажок Пропустить Ремультиплексирование исходный файл в файл TS во время преобразования.
Monitor converted videos	Контролировать преобразованные видео
By default Monitor Locations will ignore files that have already been converted.\r\nCheck this box if you also want to monitor converted files in the Monitor Path.\r\nCAUTION: This can lead to an infinite conversion loop of converted files if not configured properly.\r\n\r\nThis can be useful when you are specifying the output directory of a conversion task\r\n(converted file) as the Monitor Path of a Monitor Location and linking the\r\nMonitor Location to another conversion task.	По умолчанию мониторинг в местах будет игнорировать файлы, которые уже были converted.\r\nCheck галочку, если вы также хотите контролировать преобразованные файлы в Path.\r\nCAUTION монитор: это может привести к созданию цикла бесконечное преобразование преобразованных файлов, если не настроен properly.\r\n\r\nThis может быть полезно, когда вы указать выходной каталог преобразования task\r\n (преобразованный файл) как монитор путь расположения монитора и увязки the\r\nMonitor Расположение другой задаче преобразования.
CHECK THIS BOX AT YOUR OWN RISK.\r\nDO NOT CHECK THIS BOX UNLESS YOU KNOW WHAT YOU ARE DOING.\r\nBy default Monitor Locations will ignore files that have already been converted.\r\nCheck this box if you also want to monitor converted files in the Monitor Path.	ПРОВЕРИТЬ это поле на свой собственный RISK.\r\nDO не проверить это поле Если вы знаете что ты DOING.\r\nBy по умолчанию мониторинг в местах будет игнорировать файлы, которые уже были converted.\r\nCheck это поле, если вы также хотите контролировать преобразованные файлы в пути монитор.
Hardware encoding	Аппаратное кодирование
Check this box to use hardware encoding when available to convert videos.\r\nThis can speed up the conversion significantly and reduce the CPU utilization\r\nbut it can result in slightly lower quality videos.\r\n\r\nUncheck this box if you're facing conversion or quality issues.	Проверьте этот флажок, чтобы использовать аппаратного кодирования, когда для преобразования videos.\r\nThis можно значительно ускорить преобразования и сокращения utilization\r\nbut процессора, это может привести к несколько ниже качества videos.\r\n\r\nUncheck это поле, если вы сталкиваетесь преобразования или вопросов качества.
Do not overwrite files	Не перезаписывайте файлы
When this box is checked, the destination file will not be overwritten if it already exists.\r\nInstead a new file will be created with a unique number added to the end of the filename.	Когда этот флажок установлен, в конечный файл не будет перезаписан, если он уже exists.\r\nInstead новый файл будет создан уникальный номер добавляется в конец файла.
Re-monitor recorded videos	Повторно контролировать записанные видео
By default, once a source file (Recorded video) has been converted,\r\nthe monitor history will track the filename and not queue the same files again.\r\n\r\nEnable this option to ignore the history and monitor all files and add them to\r\nthe conversion queue, even if they have already been converted.\r\n\r\nThis can be useful sometimes, if the recording software does not generate a\r\nunique filename for each episode/show. It is reccomended to use the\r\nDelete original file option in the Settings page when using this option to avoid\r\nan infinite conversion loop.	По умолчанию, после того, как преобразовать исходный файл (записи видео), история \r\nthe монитор будет отслеживать имя файла и не очереди же again.\r\n\r\nEnable файлов этот параметр, чтобы игнорировать историю и контролировать все файлы и добавить их в очередь to\r\nthe преобразования, даже если они уже были converted.\r\n\r\nThis может быть полезным, иногда, если записи программного обеспечения не создает имя файла a\r\nunique для каждого эпизода/шоу. Рекомендуется использовать параметр исходный файл the\r\nDelete на странице параметров, при использовании этого параметра для avoid\r\nan бесконечное преобразование цикла.
Recommendation	Рекомендация
To avoid an infinite conversion loop, it is recommended to setup your Monitor search pattern in a way such as to ensure that the converted files are not being monitored by this Monitor task.	Чтобы избежать бесконечного преобразования цикла, рекомендуется настроить шаблон поиска вашего монитора в пути, такие, как обеспечить, что преобразованные файлы не контролируются этой задачи монитора.
CHECK THIS BOX AT YOUR OWN RISK.\r\nDO NOT CHECK THIS BOX UNLESS YOU KNOW WHAT YOU ARE DOING.\r\nBy default Monitor Locations will not remonitor recorded videos that have been processed.\r\nCheck this box if you want to remonitor and reconvert the recorded videos.	ПРОВЕРИТЬ это поле на свой собственный мониторинг в местах будет не remonitor по умолчанию RISK.\r\nDO не DOING.\r\nBy проверить это поле Если вы знаете, что ты записал видео, которые были processed.\r\nCheck это поле, если вы хотите remonitor и преобразовать записанные видео.
To avoid an infinite conversion loop, it is recommended that you enable Delete original file option in the Settings page.	Чтобы избежать бесконечного преобразования цикла, рекомендуется включить удалить оригинальный параметр файл на странице настроек.
Prioritize air date matching	Приоритеты воздуха Дата согласования
MCEBuddy uses the episode name to match the series information\r\nwhile searching the internet. If that fails then it uses the original broadcast\r\nair date to match the metadata.\r\n\r\nCheck this box to use the original broadcast air date first and then the\r\nepisode name to match for the series information from the internet.\r\nThis can be useful in some cases when multiple seasons have the same\r\nepisode name. E.g. Americal Idol, Audition 1\r\n\r\nNOTE: Original broadcast air date is not always accurate set by the\r\nbroadcaster and sometimes the information on the internet is incorrect.\r\nUse this option only if the default option is not working for you.	MCEBuddy использует имя эпизод серии information\r\nwhile, поиск в Интернете. Если это не помогло тогда она использует Оригинальный Дата broadcast\r\nair соответствовать metadata.\r\n\r\nCheck этот флажок, чтобы использовать оригинальный Дата трансляции воздуха сначала и затем the\r\nepisode имя для сопоставления информации серии из internet.\r\nThis может быть полезна в некоторых случаях, когда несколько сезонов имеют имя same\r\nepisode. Например Америкал идол, прослушивание 1\r\n\r\nNOTE: Оригинальный Дата трансляции воздуха не всегда является точной набор по the\r\nbroadcaster и иногда информация в Интернете является incorrect.\r\nUse этот параметр, только если параметр по умолчанию не работает для вас.
Skip eMail body	Тело письма скип
Check this option to use an empty body in the notification eMail.\r\nThis can be useful if you're using a SMS gateway for eMail notifications.	Проверьте этот параметр, чтобы использовать пустое тело в eMail.\r\nThis уведомления может быть полезным, если вы используете SMS-шлюз для уведомления по электронной почте.
Selection based on Digital Right Management (DRM) is available\r\nonly when Rename without converting (Rename and move only) option is selected.\r\n\r\nAll - Selects all files for processing, irrespective of copy protection status\r\nProtected - Only select files which are copy protected\r\nUnprotected - Only select files which do not have copy protection	Отбор на право управления (DRM) является available\r\nonly когда переименовать без преобразования (переименовывать и перемещать только) вариант selected.\r\n\r\nAll - выбирает все файлы для обработки, независимо от защиты от копирования status\r\nProtected - только выберите файлы, которые являются копией protected\r\nUnprotected - выбрать только файлы, которые не имеют защиты от копирования
Download cover art	Скачать обложку
Enable this to download the cover art from the original video and internet if available.	Включите это скачать обложки из оригинального видео и Интернета, если таковые имеются.
Are you sure you want to enter a Domain Name?\r\n\r\nUse this ONLY if you are using a Windows Domain Controller to manage your authentication.\r\nDo NOT use this if you are part of a Workgroup.\r\n\r\nIf you are unsure click NO.	Вы уверены, что вы хотите ввести имя домена? \r\n\r\nUse это только если вы используете контроллер домена Windows для управления вашей authentication.\r\nDo не использовать это, если вы являетесь частью Workgroup.\r\n\r\nIf ты не уверены нажмите нет
Configuration Warning	Предупреждение конфигурации
Creates a folder called 'MCEBuddyArchive' where the original file is located\r\nand moves the orginal file in this directory after a successful conversion.\r\n\r\nThis folder name and location be changed below.	Создает папку под названием «MCEBuddyArchive», где исходный файл является located\r\nand перемещает исходный файл в этом каталоге после успешного conversion.\r\n\r\nThis имя и расположение папки изменить ниже.
Monitoring	Мониторинг
If you want to convert the EDL file into chapters, make sure you check the 'Add Subtitles and Chapters' option in Expert Settings.	Если вы хотите преобразовать файл EDL в главах, убедитесь, что выбран параметр «Добавить субтитры и глав» в настройках эксперта.
EDL to Chapters	EDL глав
