MCEBuddy does NOT use the currently logged in user to connect to network shares, it uses its own service account.  Be sure to specify the connection user information (MCEBuddy with a key icon)	MCEBuddy använder inte den för närvarande inloggade användaren för att ansluta till nätverksresurser, den använder sina egna tjänstkonto.  Glöm inte att ange anslutningsinformation för användaren (MCEBuddy med en nyckelikon)
Connection Reminder	Anslutning påminnelse
Description	Beskrivning
Path	Sökväg
is invalid	är ogiltig
Invalid Path	Ogiltig sökväg
Please supply a task name	Vänligen lämna ett aktivitetsnamn
No name supplied	Inget namn som tillhandahålls
Please enter the 3 digit language code of the Audio track or select <Default> or <Original>	Ange språkkoden 3 siffror för ljudspår eller välj <standard>eller <Original>
The 3 digit ISO code for the selected language\r\nMake sure this matches the language code for the audio track in the original recording.\r\nTo get the language code for the audio tracks in the original recorded file, add the file\r\nto the queue and right click on it. A pop up window will open showing the audio details\r\nwhich include the language codes for each audio track.	3 Siffriga ISO-koden för den markerade language\r\nMake detta motsvarar språkkoden för ljudspår i den ursprungliga recording.\r\nTo get språkkoden för ljudspår i inspelade originalfilen, Lägg till file\r\nto kön och högerklicka på den. Ett popup-fönster öppnas visar ljud details\r\nwhich innehåller språkkoderna för varje ljudspår.
Invalid Language Code	Ogiltig språkkod
No destination directory provided, converted file will be placed in original video directory	Ingen målkatalog anges, konverterade filen placeras i ursprungliga video katalogen
A task name or section	En aktivitet eller ett avsnitt
already exists\n\rPlease use another name	exists\n\rPlease använder redan ett annat namn
Duplicate Name	Dubblettnamn
Engine	Motorn
Tasks	Aktiviteter
Profile	Profil
disposing	avyttra
Task name	Aktivitetsnamn
Give a unique name to this task	Ge ett unikt namn för denna uppgift
Gives a short description for the selection conversion profile	Ger en kort beskrivning för konverteringsprofil val
Click to select destination folder	Klicka för att välja målmapp
Destination	Destination
Select the directory where the converted file will be placed.\r\nLeave this blank to keep the converted file in the same directory as the original video.	Välj katalogen där den konverterade filen kommer att placed.\r\nLeave detta tom att hålla den konverterade filen i samma katalog som original video.
Max width	Max bredd
This will limit the maximum width (in pixels) of the video for the converted file.\r\nTIP: Does not apply if the original file has a width smaller than this number.\r\nIf you want to keep your original video resolution move the slider all the way to the right.	Detta kommer att begränsa den maximala bredden (i pixlar) på video för den konverterade file.\r\nTIP: gäller inte om den ursprungliga filen har en bredd av mindre än denna number.\r\nIf som du vill behålla din ursprungliga videoupplösning flytta skjutreglaget till höger.
Quality	Kvalitet
Ad remover	Annons flytta
None	Ingen
Get series details from Internet	Hämta serie detaljer från Internet
Download additional details about the movie or series from the internet	Hämta ytterligare detaljer om film eller serie från internet
File name match	Filen namnet matchen
Recording title match	Inspelning avdelning matchen
Cancel	Avbryt
OK	Okej
Rename without converting	Byt namn på utan att konvertera
Check this option to only rename and copy the original files to the destination folder.\r\nWhen checked, conversion, trimming, audio/video processing and commercial removal will not be available.\r\n\r\nNOTE: Other functions like matching filters, extracting subtitles, saving metadata and commercial detection (saving EDL file)\r\nwill still be available with this option checked.\r\nIf you want to move instead of copy, check the Skip copying original option in Expert Settings on this page or select\r\nDelete original file in the main settings page.	Kontrollera att alternativet att bara byta namn och kopiera de ursprungliga till den destination folder.\r\nWhen markerat, konvertering, putsning, audio/video bearbetning och kommersiella borttagning inte kommer att available.\r\n\r\nNOTE: andra fungerar som matchande filter, extrahera undertexter, spara metadata och kommersiella upptäckt (spara EDL) \r\nwill fortfarande vara tillgängliga med detta alternativet checked.\r\nIf du vill flytta i stället för kopia, kontrollera hoppa kopiering original alternativ i Expert inställningarna på denna sida eller select\r\nDelete originalfilen i viktigaste inställningar.
Rename and sort by video information	Byta namn på och sortera efter videoinformation
Renames the converted file and places it in a new directory based on the show/series information when available\r\n(e.g. ShowName\\ShowName-SXXEYY-EpisodeName-RecordDate)	Byter namn på den konverterade filen och placerar den i en ny katalog som baseras på informationen som Visa/serie när available\r\n (t.ex. ShowName\\ShowName-SXXEYY-EpisodeName-RecordDate)
Enter the username and password to access folders that are on a network drive or a different computer	Ange användarnamn och lösenord för åtkomst mappar som finns på en nätverksenhet eller en annan dator
Organize by seasons	Ordna av säsonger
Organize folders by Showname and Season when available (Media Center/XBMC/Plex compatible naming convention)\r\n(e.g. Showname\\Season XX\\SXXEYY-Episode Name)	Organisera mappar av Showname och säsong när tillgängliga (Media Center/XBMC/Plex kompatibel namngivningskonvention) \r\n (t.ex. Showname\\Season XX\\SXXEYY-Episode namn)
Audio language	Ljud språk
Advanced Settings	Avancerade inställningar
General Settings	Allmänna inställningar
Conversion Task	Konvertering aktivitet
Password	Lösenord
Confirm Password	Bekräfta lösenord
Domain / computer name	Domän / datornamn
<Optional> Enter if remote computer or network drive uses a Domain for authentication.\r\nDo NOT enter your workgroup here. Leave this blank if you're using a workgroup.	<Optional>Ange om datorn eller nätverket fjärrenhet använder en domän för authentication.\r\nDo inte in din arbetsgrupp här. Lämna fältet tomt om du använder en arbetsgrupp.
User name	Användarnamn
Enter the username to access the remote computer or network drive	Ange användarnamn att få tillgång till datorn eller nätverket fjärrenhet
Enter the password to access the remote computer or network drive	Ange lösenord för att komma åt datorn eller nätverket fjärrenhet
Network Connection User Credentials	Anslutning användaren nätverksreferenser
Password Mismatch	Lösenord fel
Passwords do not match, please reenter the passwords	Lösenorden matchar inte, bekräfta vänligen lösenord
Hour	Timme
Minute	Minut
Wake	Vakna
Start	Starta
Resume	Meritförteckning
Pause	Paus
Stop	Stanna
Language	Språk
Pause conversion tasks	Paus konvertering aktiviteter
Resume conversion tasks	Återuppta konvertering aktiviteter
Please enter a valid time	Ange en giltig tid
Invalid Time	Ogiltig tid
Stop time is after Start time. Assuming the Stop time is during the next day, is that correct?	Stopptid är efter starttid. Antar att stopptiden är under nästa dag, stämmer det?
Time Check	Kontroll
Only select this option if MCEBuddy has been converting your files reliably for an acceptable period of time. Do you wish MCEBuddy to delete each original file once it has been converted?	Välj bara detta alternativ om MCEBuddy har konverterar dina filer på ett tillförlitligt sätt för en godtagbar tidsperiod. Vill du MCEBuddy att ta bort alla ursprungliga filer när det har konverterats?
Confirm delete originals?	Bekräfta ta bort original?
MCEBuddy will monitor these directories for video files to convert automatically	MCEBuddy kommer att övervaka dessa kataloger för videofiler konvertera automatiskt
Conversion tasks	Konvertering aktiviteter
Delete original file	Ta bort originalfilen
Deletes the original recording after a successful conversion	Tar bort den ursprungliga inspelningen efter en framgångsrik omräkning
Min age before conversion (hours)	Min ålder innan konverteringen (timmar)
Minimum hours to wait before converting each file after the file is added to the queue	Minsta timmar vänta innan du konverterar varje fil när filen har lagts till i kön
Use this to change the language of the text on the screen	Används för att ändra språket för texten på skärmen
Concurrent conversions	Samtidiga konverteringar
Number of simultaneous conversions MCEBuddy can start\r\nNOTE: You need large amounts of free disk space and processor time for more than 2 simultaneous conversions	Antalet samtidiga konverteringar MCEBuddy kan start\r\nNOTE: du behöver stora mängder ledigt utrymme och processor tid för mer än 2 samtidig konverteringar
Logging level	Loggningsnivå
Error	Fel
Warning	Varning
Information	Information
Debug	Felsöka
Log conversion jobs	Logga konvertering jobb
Save a log file for each conversion in the \'logs\' directory where where MCEBuddy is installed\r\n(e.g. C:\\Program Files\\MCEBuddy2x\\logs)	Spara en loggfil för varje omställning i \'logs\' katalog där där MCEBuddy är installed\r\n (t.ex. C:\\Program Files\\MCEBuddy2x\\logs)
Allow sleep	Tillåt sömn
If unchecked, it prevents the system from entering sleep while converting	Om oskyddad, förhindrar det att ange sömn vid konvertering
Stop at	Stanna vid
No new conversions would be started after this time	Inga nya konverteringar skulle startas efter denna tid
minute	minut
hour	timme
If checked MCEBuddy will wake the system from sleep\r\nat the specified Start time and enabled days of the week.	Om kollade MCEBuddy kommer att väcka datorn ur sleep\r\nat angivna starttiden och aktiverat dagar i veckan.
Start at	Starta vid
MCEBuddy will start new conversions between the Start and Stop time.\r\n\r\nThe Start time will be used for the enabled days of the week, whereas\r\nthe End time will be used either for the same day or\r\nfor the next day if the End time is after the Start time.	MCEBuddy startar ny konverteringar mellan Start och stopp time.\r\n\r\nThe Start tid kommer att användas för de aktiverade dagarna i veckan, whereas\r\nthe slut tid kommer att användas antingen för den samma dag or\r\nfor nästa dag om sluttiden efter starttid.
Delete	Ta bort
Add	Lägga till
Change	Ändra
Archive original file	Ursprungliga arkivfil
Domain name	Domännamn
Stops the monitor and conversion tasks and opens a page to configure MCEBuddy	Slutar de monitor och konvertering uppgifterna och öppnar en sida för att konfigurera MCEBuddy
Creates a folder called \'MCEBuddyArchive\' where the original file is located\r\nand moves the orginal file in this directory after a successful conversion.\r\n\r\nThis folder name and location be changed in the System Settings page.	Skapar en mapp som heter \'MCEBuddyArchive\ "där den ursprungliga filen är located\r\nand flyttar orginal filen i katalogen efter framgångsrika conversion.\r\n\r\nThis mappnamn och plats ändras i Systeminställningar.
Debug - detailed logs, helps trace conversion problems\r\nInformation - logs basic information about conversion\r\nWarning - log potential issues or critical failures only\r\nError - log critical failures only	Debug - detaljerade loggar, hjälper dig att spåra problems\r\nInformation - loggar in grundläggande information om conversion\r\nWarning - loggen potentiella konverteringsproblem eller kritiska fel only\r\nError - logga kritiska fel endast
Select the conversion profile associated with this task. The conversion profile represents the output format and quality for the converted file.\r\nHigher quality conversions take longer to convert. Reccomended Default: MP4 High Quality or MP4 Normal.\r\n\r\nTIP: Refer to the MCEBuddy Guide for advanced parameters to tweak conversion profiles or to create your own conversion profiles	Välj konverteringsprofil som är associerad med denna uppgift. Konverteringsprofil representerar utdataformat och kvalitet för konverterade file.\r\nHigher kvalitet konverteringar ta längre tid att konvertera. Reccomended standard: MP4 hög kvalitet eller MP4 Normal.\r\n\r\nTIP: installationshandboken för MCEBuddy för avancerade parametrar att justera konverteringen profiler eller skapa din egen konvertering profiler
Select the program MCEBuddy will use to strip out any commercials while converting the video.\r\nSet to 'None' to leave the commercials in the converted video.\r\n\r\nTIP: To use ShowAnalyzer instead of Comskip, please download and install ShowAnalyzer.\r\nShow Analyzer version 1.0 and greater supported.	Välj det program som MCEBuddy använder för att ta bort någon reklam vid konvertering av video.\r\nSet till ingen att lämna reklamfilmerna i den konverterade video.\r\n\r\nTIP: att använda ShowAnalyzer istället för Comskip, vänligen ladda ner och installera ShowAnalyzer.\r\nShow Analyzer version 1.0 och större stöd.
Used to change the video quality of the converted file, normal is 1.\r\nA higher number will improve quality but will take more time for conversion.\r\nA smaller number will reduce the quality but speed up the conversion.	Används för att ändra videokvaliteten av den konverterade filen, normalt är 1.\r\nA högre nummer kommer att förbättra kvaliteten men kommer att ta mer tid för conversion.\r\nA mindre tal kommer att sänka kvaliteten men påskynda omställningen.
Enter pattern to match filenames for this task (e.g. *.wtv will convert all files ending with .wtv)\r\nPrefix pattern with ~ to skip the match (e.g. *.*;~*.wtv will process all files except those ending with .wtv)\r\nSeparate multiple patterns with ; (e.g. *.wtv;ncis*;~ncis miami*) will process all .wtv files and all files starting with ncis but not those starting with ncis miami\r\n\r\nYou can use regular expressions to match the pattern by starting with regex:	Ange mönster för att matcha filnamn för denna uppgift (t.ex. *.wtv kommer att konvertera alla filer som slutar med .wtv)\r\nprefix mönster med ~ att hoppa över matchen (t.ex. *. *, ~*.wtv kommer att bearbeta alla filer utom de som slutar med .wtv)\r\nseparate flera mönster med; (t.ex. *.wtv, ncis *, ~ ncis miami *) kommer att bearbeta alla WTV och alla filer som börjar med ncis men inte de som börjar med ncis miami\r\n\r\nYou kan använda reguljära uttryck för att matcha mönstret genom att börja med regex:
Enter pattern to match show/series titles for this task (e.g. Simpson* will convert all files that have a show title starting with Simpson)\r\nPrefix pattern with ~ to skip the match (e.g. *;~Simpson* will process all show titles except those that start with Simpson)\r\nSeparate multiple patterns with ; (e.g. Simpson*;House*) or (e.g. Simpson*;NCIS*;~NCIS Miami*)\r\n\r\nYou can use regular expressions to match the pattern by starting with regex:	Ange mönster för att matcha Visa/serien titlar för denna uppgift (t.ex. Simpson * kommer att konvertera alla filer som har ett Visa titel börjar med Simpson) \r\nPrefix mönster med ~ att hoppa över matchen (t.ex. *, ~ Simpson * kommer att bearbeta alla Visa titlar utom de som börjar med Simpson) \r\nSeparate flera mönster med; (t.ex. Simpson *;House*) eller (e.g. Simpson *;NCIS*; ~ NCIS Miami *) \r\n\r\nYou kan använda reguljära uttryck för att matcha mönstret genom att börja med regex:
This can be used to override the default Audio Language when there are multiple audio languages in a recording.\r\nTo get the list of the Audio Languages in a recording, right click on the file in the queue and select MediaInfo.\r\n\r\n<Default> will try to keep all audio tracks if supported or let the encoder choose the default audio track\r\n<Original>, if available, will use the original [non-dubbed] recording language	Detta kan användas för att åsidosätta standardvärdet ljudspråk när det finns flera ljudspråk i en recording.\r\nTo få listan över ljudspråk i en inspelning, högerklicka på filen i kön och välj MediaInfo.\r\n\r\n <Default>kommer att försöka hålla alla ljudspår om stöds eller låt kodaren väljer standard ljud track\r\n <Original>, om tillgängligt, kommer att använda [icke-dubbade] inspelning originalspråk
Enter '[video]' or leave blank to convert all video files\r\nEnter pattern to match filenames for this location (e.g. *.wtv will convert all files ending with .wtv)\r\nPrefix pattern with ~ to skip the match (e.g. *.*;~*.wtv will process all files except those ending with .wtv)\r\nSeparate multiple patterns with ; (e.g. *.wtv;ncis*;~ncis miami*) will process all .wtv files and all files starting with ncis but not those starting with ncis miami	Ange [video] eller lämna tomt om du vill konvertera alla video files\r\nEnter mönster för att matcha filnamn för den här platsen (t.ex. *.wtv konverteras alla filer som slutar med .wtv)\r\nprefix mönster med ~ hoppa över matchen (t.ex. *. *; ~*.wtv kommer att bearbeta alla filer utom de som slutar med .wtv)\r\nseparate flera mönster med; (t.ex. *.wtv och ncis *; ~ ncis miami *) kommer att behandla alla WTV och alla filer som börjar med ncis men inte de som börjar med ncis miami
MCEBuddy Settings	MCEBuddy inställningar
MCEBuddy does NOT use the currently logged in user to connect to network shares, it uses its own service account.  Be sure to specify the connection user information [MCEBuddy with a key icon]	MCEBuddy använder inte den för närvarande inloggade användaren för att ansluta till nätverksresurser, den använder sina egna tjänstkonto.  Glöm inte att ange anslutningsinformation för användaren [MCEBuddy med en nyckelikon]
Please supply a source name	Vänligen lämna ett källnamn
Please supply a search path name	Vänligen lämna ett söknamn sökväg
A source name or section	En datakällans namn eller ett avsnitt
already exists. Please use another name	Det finns redan. Använd ett annat namn
Monitor name	Övervaka namn
Give this a location a unique name	Ger detta en plats ett unikt namn
Monitor path	Övervaka sökväg
Select the directory that MCEBuddy will monitor in the background for new video files to convert automatically	Markera den katalog som MCEBuddy kommer att övervaka i bakgrunden för nya videofiler konvertera automatiskt
Click to select the folder to monitor	Markera mappen att övervaka
Search pattern	Söksträng
SourceForm	SourceForm
Monitor Location	Övervaka plats
Normal	Normal
MCEBuddy GUI: pipeProxy engine connection error	MCEBuddy GUI: pipeProxy motorn anslutningsfel
MCEBuddy GUI: Unable to create pipe to MCEBuddy service	MCEBuddy GUI: Det gick inte att skapa pipe MCEBuddy tjänst
The MCEBuddy service is unavailable. Please start from Windows control panel or check engine connection.	MCEBuddy-tjänsten är inte tillgänglig. Starta från Kontrollpanelen i Windows eller kontrollera om motorn.
Announcement	Tillkännagivande
New version 	Ny version 
available	tillgängliga
New BETA version 	Ny betaversion 
Click here to download new version of MCEBuddy	Klicka här för att hämta ny version av MCEBuddy
Click here to open link	Klicka här för att öppna länken
Idle	Inaktivitet
Closing	Stänga
MCEBuddy GUI: Unable to update tasks	MCEBuddy GUI: Det gick inte att uppdatera aktiviteter
MCEBuddy GUI: Unable to start MCEBuddy service	MCEBuddy GUI: Det gick inte att starta MCEBuddy service
MCEBuddy GUI: Unable to stop MCEBuddy service	MCEBuddy GUI: Det gick inte att stoppa MCEBuddy
MCEBuddy GUI: Unable to cancel job	MCEBuddy GUI: Det gick inte att avbryta jobbet
Warning: Networked files will be accessed using the logon credentials of the MCEBuddy Service, not the currently logged on user. You can manually specify the network credentials from the Settings -> Expert Settings page in MCEBuddy.	Varning: Nätverksanslutna filer kommer att nås med autentiseringsuppgifterna för inloggning på MCEBuddy servicen, inte den inloggade användaren. Du kan manuellt ange nätverksreferenser i inställningarna-> Expert inställningar i MCEBuddy.
Credential Warning	Certifieringen varning
Status	Status
MCEBuddy GUI: Unable to add job	MCEBuddy GUI: Det gick inte att lägga till jobb
MCEBuddy GUI: Unable to get pipe active status	MCEBuddy GUI: Det gick inte att hämta pipe aktiv status
The conversions must be stopped to change settings. Stop the conversions?	Omvandlingarna måste stoppas för att ändra inställningar. Stoppa omvandlingar?
Stop Engine	Stoppa motorn
MCEBuddy GUI: Unable to stop MCEBuddy service from settings click	MCEBuddy GUI: Det gick inte att stoppa MCEBuddy tjänsten från inställningar Klicka på
MCEBuddy GUI: Unable to rescan files	MCEBuddy GUI: Det gick inte att skanna filer
MCEBuddy GUI: Unable to open link	MCEBuddy GUI: Det gick inte att öppna länk
Close	Stäng
Close this window, MCEBuddy will keep running in the background	Stäng det här fönstret, MCEBuddy kommer att hålla körs i bakgrunden
If you like MCEBuddy, please click here to Donate - THANKS	Om du gillar MCEBuddy, vänligen klicka här för att donera - tack
Click here to like MCEBuddy on facebook	Klicka här för att gilla MCEBuddy på facebook
Click here to open MCEBuddy website	Klicka här för att öppna MCEBuddy webbplats
Rescan	Omsökning
Forces the MCEBuddy to recheck the Monitor locations for new video files to convert	Tvingar MCEBuddy att omtolka Monitor platser för nya videofiler konvertera
Monitor locations	Monitor platser
Settings	Inställningar
Select the file(s) in the queue to delete	Markera filen eller filerna i kön att ta bort
Manually add video file(s) to the queue to convert	Manuellt lägga till video fil(er) kön att konvertera
Start the MCEBuddy monitor and conversion tasks	Starta MCEBuddy bildskärm och omställning aktiviteter
Stop the MCEBuddy monitor and conversion tasks	Stoppa MCEBuddy bildskärm och omställning aktiviteter
There is a new version!	Det finns en ny version!
High	Hög
Low	Låg
Priority	Prioriterade
High priority - convert faster but may make other running applications unresponsive\r\nLow priority - convert in the background but reduced interference with other running applications	Hög prioritet - konvertera snabbare men kan prioritera andra program som körs unresponsive\r\nLow - konvertera i bakgrunden men minskad störning med andra program som körs
A task is a conversion template that contains a conversion profile and various other conversion parameters.\r\nEach file added to the queue will be processed and converted by each of these tasks.\r\nRefer to the MCEBuddy Guide for more details on how tasks work.	En aktivitet är en konvertering mall som innehåller en konverteringsprofil och olika andra konvertering parameters.\r\nEach fil läggs till i kön kommer att bearbetas och konverteras genom vart och ett av dessa tasks.\r\nRefer MCEBuddy guide för mer information om hur uppgifter fungerar.
Getting started	Komma igång
Click here for MCEBuddy guide	Klicka här för MCEBuddy guide
Logs	Loggar
Click to open log folder	Klicka för att öppna loggmappen
MCEBuddy Status	MCEBuddy Status
add	lägga till
delete	ta bort
paypal-donate	PayPal-donera
stop	Stanna
OUTPUT: ConsoleOuput received NULL data	UTDATA: ConsoleOuput NULL data som tas emot
hours	timmar
minutes	minuter
second	andra
seconds	sekunder
Starting	Börjar
Comskip advertisement scan - Pass 1	Comskip annons scan - Pass 1
Comskip advertisement scan - Pass 2	Comskip annons scan - Pass 2
Cutting commercials from video	Styckning reklamfilmer från video
Cutting commercials from video - segment 	Styckning reklamfilmer från video - segmentet 
Merging commercial free segments into new video	Sammanfoga kommersiella fria segment till ny video
Moving converted file to destination	Flytta konverterade filen till destination
Checking for disk space	Kontroll av diskutrymme
Getting show information and banner from Internet sources	Att få visa information och banner från källor på Internet
Copying source file to working directory	Kopiera källfilen till arbetskatalogen
Remuxing recording	Remuxing inspelning
ShowAnalyzer advertisement scan	ShowAnalyzer annons scan
Comskip advertisement scan	Comskip annons scan
Analyzing video information	Analysera video information
Converting	Konvertera
Removing commercials	Ta bort reklamfilmer
Writing show information	Skriftligt visa information
Renaming file using show information	Byta namn på filen med hjälp av visa information
Success - All done!	Framgång - alla klar!
Muxing streams	Muxing strömmar
Fallback remux	Återgångsregler remux
Correcting audio delay	Korrigera audio delay
Converting video file - Pass 1	Konvertera videofilen - Pass 1
Converting video file - Pass 2	Konvertera videofilen - Pass 2
Converting video file	Konvertera videofilen
Audio Track	Ljudspår
Impaired	Nedsatt
Channels	Kanaler
Codec	Codec-enheten
Video	Video
Duration	Varaktighet
Height	Höjd
Width	Bredd
Audio	Ljud
Name	Namn
Subtitle	Underrubrik
Volume	Volym
Enable custom file renaming	Aktivera anpassad fil namnändring
Enable this to enter a custom pattern to rename converted files and folders. Enter the custom pattern in the box below.\r\n\r\nExample:\r\nTVShows\%showname%\Season %season%\%showname% - S%season%##E%episode%## - %episodename% - %airyear%_%airmonth%_%airday%\r\n\r\nWill produce:\r\nTVShows\CSI\Season 1\CSI - S01E02 - Best of times - 2012_01_06.<ext>\r\n\r\nExample:\r\nRecording\%ismovie%<Movie\%showname%,TVShows\%showname%\Season %season%\%showname% - S%season%##E%episode%##>-Converted\r\n\r\nWill produce (for a movie)\r\n    Recording\Movies\Star Wars-Converted.<ext>\r\nOR (for non movies)\r\n    Recording\TVShows\CSI\Season 1\CSI - S01E02-Converted.<ext>\r\n\r\nRefer to the MCEBuddy advanced documentation for a list of all the pattern commands.	Möjligt att ange ett anpassat mönster om du vill byta namn på konverterade filer och mappar. Ange anpassade mönstret i rutan below.\r\n\r\nExample:\r\nTVShows\%showname%\Season %season%\%showname% - S % säsongen % ##E % episod % ##-% episodename % - %airyear%_%airmonth%_%airday%\r\n\r\nWill råvaror: \r\nTVShows\CSI\Season 1\CSI - S01E02 - bästa av tider - 2012_01_06.<ext>\r\n\r\nExample:\r\nRecording\%ismovie% < Movie\%showname%,TVShows\%showname%\Season %season%\%showname% - S%season%##E%episode%##>-Converted\r\n\r\nWill produkter (för en film) \r\n Recording\Movies\Star krig-konverterade. <ext>\r\nOR (för icke filmer) \r\n Recording\TVShows\CSI\Season 1\CSI - S01E02-konverterade.<ext>\r\n\r\nRefer till MCEBuddy avancerad dokumentation för en lista av alla kommandon som mönster.
ShowAnalyzer not found.\nPlease download and install ShowAnalyzer.	ShowAnalyzer kunde inte hittas. \nSkriv Hämta och installera ShowAnalyzer.
ShowAnalyzer Missing	ShowAnalyzer saknas
Invalid language code, reverting to <Default> language	Ogiltig språkkod, återgå till <standard>språk
Cut start	Skär start
Cut end	Skär slutet
This specifies the number of seconds to cut from the start of the recording (BEFORE removing the ads)	Detta anger hur många sekunder att skära från början av inspelningen (innan du tar bort annonser)
This specifies the number of seconds to cut from the end of the recording (BEFORE removing the ads)	Detta anger hur många sekunder att skära från slutet av inspelningen (innan du tar bort annonser)
Send an eMail after each conversion.	Skicka ett e-postmeddelande efter varje konvertering.
Send eMail	Skicka e-post
SMTP Server Name	SMTP-servernamn
Enter the outgoing eMail (SMTP) server address here\r\ne.g. smtp.gmail.com	Ange utgående e-post (SMTP) servern adress here\r\ne.g. SMTP.Gmail.com
Port	Port
Enter the SMTP server port	Ange SMTP-serverport
Use SSL	Använd SSL
Check this if you SMTP server uses SSL	Markera detta alternativ om du SMTP server använder SSL
e-Mail Settings	e-postinställningar
From <e-Mail>	Från <e-Mail>
Enter the senders (From) eMail address here	Ange avsändare (från) e-postadress här
To <e-Mails>	Till <e-Mails>
Enter the recipients (To) eMail address here.\r\nSeparate multiple recipients with a semicolon (;)	Ange mottagare (till) eMail adress here.\r\nSeparate flera mottagare med ett semikolon (;)
Send eMail on successful conversion	Skicka e-post på framgångsrika konvertering
Send eMail on failed conversion	Skicka e-post på misslyckade konvertering
Send eMail on cancelled conversion	Skicka e-post på inställda konvertering
Send eMail on adding a conversion to the queue	Skicka e-post på att lägga till en konvertering till kön
Please enter a valid server address	Ange en giltig serveradress
Invalid SMTP Server	Ogiltig SMTP-Server
Please enter a valid server port	Ange en giltig serverport
Invalid SMTP Port	Ogiltig SMTP-Port
Please enter a valid From eMail address	Ange ett giltigt från e-postadress
Invalid eMail Address	Ogiltig eMail adress
Please enter valid To eMail addresses	Ange giltigt till e-postadresser
Username	Användarnamn
<Optional> Enter the username for the eMail server authentication	<Optional>RETUR användarnamn för e-post server-autentisering
<Optional> Enter the password for the eMail server authentication	<Optional>Ange lösenordet för e-post server-autentisering
MCEBuddy unable to download series information	MCEBuddy det gick inte att hämta serieinformationen
MCEBuddy successfully converted a video	MCEBuddy omvandla har lyckats en video
Source Video	Källvideo
Converted Video	Konverterad Video
Converted At	Konverteras I
MCEBuddy failed to converted a video	Det gick inte att konvertera en video MCEBuddy
Failed At	Misslyckades vid
MCEBuddy cancelled a video conversion	MCEBuddy avbröts en videokonvertering
Cancelled At	Återkallas vid
Working	Arbetar
Test	Testet
Testing	Testning
Click this button to test the eMail server settings	Klicka på knappen Testa e-serverinställningar
MCEBuddy will send an eMail to test the server settings.\r\nThis can take upto 60 seconds.\r\nMCEBuddy may be unresponsive during this period.	MCEBuddy kommer att skicka ett e-postmeddelande att testa servern settings.\r\nThis kan ta upp till 60 seconds.\r\nMCEBuddy får inte svarar under denna period.
Test eMail	Testa e-post
MCEBuddy Test eMail	MCEBuddy Test e-post
MCEBuddy - Have a great day!	MCEBuddy - har en stor dag!
Send eMail test successful	Skicka e-post test framgångsrika
Send eMail test failed! Please check your settings and internet connectivity	Skicka e-post testet misslyckades! Kontrollera dina inställningar och internet-anslutningar
Test eMail Success	Testa e-post framgång
Test eMail Failed	Testa e-post misslyckades
Send eMail on start of conversion	Skicka e-post på start av omställning
MCEBuddy started a video conversion	MCEBuddy startade en videokonvertering
Conversion Started At	Konvertering började vid
Yes (Comskip)	Ja (Comskip)
Yes (ShowAnalyzer)	Ja (ShowAnalyzer)
Atleast one Conversion Task must be enabled	Minst en konvertering aktivitet måste aktiveras
Disable	Inaktivera
Enable	Aktivera
Rename	Byta namn på
Move	Flytta
Up	Upp
Down	Ner
Slow Remuxing	Långsam Remuxing
Extracting closed captions	Extrahera textning
Validating closed captions	Validera textning
Extracting subtitles	Extrahera undertexter
Trimming closed captions	Trimning slutna bildtexter
Extract subtitles and closed captions	Extrahera undertexter och dold textning
Field	Fältet
Channel	Kanal
Enable this to extract Closed Captions, Subtitles and Teletext from\r\nWTV, DVR-MS, TS, MP4, MKV and other supported files.\r\n\r\nIt is saved as a Subtitle (SRT) file.	Aktivera detta att extrahera slutna bildtexter, textremsor och text-TV-from\r\nWTV, DVR-MS, TS, MP4, MKV och andra stöds files.\r\n\r\nIt sparas som en Subtitle (SRT) fil.
Enable this to set advanced options for Closed Captions extraction\r\nField - 1 or 2\r\nChannel - 1 or 2\r\n\r\nDefault: Field 1, Channel 1	Aktivera här om du vill ange avancerade alternativ för stängda bildtexter extraction\r\nField - 1 eller 2\r\nChannel - 1 eller 2\r\n\r\nDefault: fältet 1, kanal 1
Subtitle offset	Subtitle offset
Enter the number of seconds (+ve / -ve) to adjust the subtitles sync with video	Ange antalet sekunder (+ ve / - ve) justera undertexter synkroniseringen med video
Re-ReMuxing due to audio error	Re-ReMuxing ljud fel
Save the poster and show information (metadata) in a MC/XBMC compatible NFO file (XML format)	Spara affischen och Visa information (metadata) i en MC/XBMC kompatibel NFO fil (XML-format)
Check this box to save the show information (metadata) in the converted file.\r\nThis only works for files that support metadata tags like MP4, MKV, WTV etc.\r\n\r\nNOTE: Uncheck this box if you're facing issues with some devices such as older TV's which have problem reading metadata.	Markera den här kryssrutan om du vill spara Visa information (metadata) i den konverterade file.\r\nThis bara fungerar för filer som stöder metadatataggar som MP4, MKV, WTV etc.\r\n\r\nNOTE: Avmarkera denna ruta om du står inför problem med vissa enheter som äldre TV som har problemet behandlingen metadata.
Atleast one day of the week must be enabled	Minst måste en dag i veckan aktiveras
Invalid Days of Week	Ogiltig dagar i veckan
Invalid day of week found in configuration file	Ogiltig dagen i veckan hittades i konfigurationsfilen
Scheduling	Schemaläggning
Remuxing to	Remuxing till
Part	Del
Rest your mouse on any button, box or item to get Instant Help on it.\n\nFor more information on how to use, troubleshoot or get support for MCEBuddy click on the <Getting Started> link on the top right corner.\n\nDonations are always welcome :) Enjoy!\n\n  - Ramit, Derek & Goose	Resten musen på knappen, box eller objekt för att få omedelbar hjälp på it.\n\nFor mer information om hur du använder, felsöka eller få stöd för MCEBuddy Klicka på länken < Komma Igång > på den topp rätt corner.\n\nDonations är alltid välkomna :) Njut! \n\n - Ramit, Derek & gås
Welcome to MCEBuddy	Välkommen till MCEBuddy
Multichannel audio	Flerkanals ljud
Check to allow multi-channel audio if the source video supports it.\r\nBy default the audio is limited to 2 channels (stereo).	Kontrollera att tillåta flerkanaligt ljud om källvideo stöder it.\r\nBy standard ljudet är begränsad till 2 kanaler (stereo).
Dynamic Range Compression (DRC)\r\nWhen the source is an AC3 audio, enabling DRC will\r\nreduce the difference between the loud and the soft\r\nsounds making the audio track more even.\r\nIf you have a multi-channel audio recording and you\r\nfeel the volume is too soft, checking this box might help.	Dynamic Range komprimering (DRC) \r\nWhen källan är en AC3-ljud, så att demokratiska republiken Kongo will\r\nreduce skillnaden mellan det högt och det soft\r\nsounds att ljudspåret mer even.\r\nIf du ha ett flerkanaligt ljud inspelning och you\r\nfeel volymen är alltför mjuk, kontrollera här om du kan hjälpa.
FPS	FPS
Logfile age (days)	Logfile ålder (dagar)
Maximum number of days to keep the logfiles before deleting them.\r\nSet to 0 to keep the logs forever.	Maximalt antal dagar som loggfilerna innan du tar bort them.\r\nSet till 0 för att hålla stockarna forever.
DVRMS Remuxing	DVRMS Remuxing
Fast Remuxing	Snabb Remuxing
Byte stream remuxing	Byte ström remuxing
Disable cropping	Inaktivera beskärning
Check this to disable cropping the video automatically during conversion.\r\nCropping is used to remove the "black bars" in the video (top, bottom, left or right).\r\nUse this option if the video picture is getting cut on any side or if the final picture is looking stretched or distorted.	Kontrollera att inaktivera Beskär video automatiskt under conversion.\r\nCropping används för att ta bort de "svarta fält" i videon (överkant, nederkant, vänster eller right).\r\nUse det här alternativet om video bilden klipps är att komma på någon sida eller om den slutliga bilden ser sträcks ut eller snedvrids.
Only detect Ads	Identifieras endast annonser
Check this if you want MCEBuddy to detect the ads (commercials) but NOT cut them from the video.\r\nWhen this option is enabled, MCEBuddy will create an EDL file along with the converted file that specifies the locations of ads in the converted video.\r\nAlso, for MP4, M4V and MKV files MCEBuddy will create Chapters to mark the end of commercials.	Markera detta om du vill MCEBuddy att upptäcka annonser (reklam) men inte klippa dem från den video.\r\nWhen detta alternativ är aktiverat, MCEBuddy kommer att skapa en EDL-fil tillsammans med den konverterade filen som anger placeringen av annonser i den konverterade video.\r\nAlso, för MP4, M4V och MKV-filer MCEBuddy kommer att skapa kapitel för att markera slutet av reklamfilmer.
Download information	Hämta information
Correction	Korrigering
Click here to correct the Show title and force use of a specific TVDB series id or IMDB movie id\r\nto lookup additional metadata from the internet.	Klicka här för att korrekt Visa titeln och tvinga användning av en specifik TVDB rad-id eller IMDB film id\r\nto sökning ytterligare metadata från internet.
Check this to download additional information from the internet about the show like a banner file, episode, season etc	Markera detta om du vill hämta mer information från internet om Visa som en banderoll fil, episod, säsongen m.m.
Profile Error	Profil fel
Cannot find selected profile in profiles.conf	Kan inte hitta markerad profil i profiles.conf
Invalid Profile	Ogiltig profil
Please select a valid profile	Välj en giltig profil
The MCEBuddy Engine has crashed. Please send mcebuddy.log to the developers	MCEBuddy motor har kraschat. Vänligen skicka mcebuddy.log till utvecklare
Comskip INI	Comskip INI
Select the custom Comskip INI file to use for this conversion task\r\nLeave this blank to use the default Comskip INI file for advertisement removal	Välj anpassad Comskip ini-filen ska användas för denna omställning task\r\nLeave här tomt som använder standard Comskip ini-filen för annons borttagning
Click to select custom Comskip INI file	Markera anpassad Comskip INI-fil
Select the folder for working with temporary files. Make sure there is enough empty space on the drive.\r\nLeave this blank to use the default temp folder in the installation folder.	Välj mappen för att arbeta med temporära filer. Kontrollera att det finns tillräckligt många tomma utrymme på drive.\r\nLeave här tomt att använda standard temp-mappen i installationsmappen.
Select the folder for working with temporary files. Make sure there is enough empty space on the drive.\r\nThis overrides the temp folder specified in the Settings -> Expert Settings page.	Välj mappen för att arbeta med temporära filer. Kontrollera att det finns tillräckligt med tomt utrymme på drive.\r\nThis åsidosätter temp mappen som angetts i inställningarna-> Expert inställningar.
Click to select temp working folder	Markera den temporära arbetsmappen
Temp folder	Temp-mappen
Space check	Utrymme kryssrutan
When enabled MCEBuddy will check for enough free space for the conversion (destination and temp).\r\nUncheck this if you have are having trouble with network drives or have extraordinarily large video files.	När aktiverade MCEBuddy kommer att kontrollera för tillräckligt med utrymme för konvertering (destination och temp).\r\nUncheck detta om du har är med problem med nätverksenheter eller har utomordentligt stora videofiler.
MCEBuddy Windows Event Logs	MCEBuddy Windows händelseloggar
Events	Händelser
Click here to open the MCEBuddy Windows Event Logs	Klicka här för att öppna MCEBuddy Windows händelseloggar
Enable UPnP	Aktivera UPnP
Check this to enable UPnP. This allows access to MCEBuddy engine from outside the network.\r\nThis needs to be checked if you're using a mobile/standalone MCEBuddy client to access MCEBuddy.	Markera detta om du vill aktivera UPnP. Detta gör att tillgången till MCEBuddy motor från utanför network.\r\nThis måste kontrolleras om du använder en mobil/fristående MCEBuddy klienten att komma åt MCEBuddy.
Click here to connect to another MCEBuddy engine	Klicka här för att ansluta till en annan MCEBuddy motor
MCEBuddy Remote Engine Connection	MCEBuddy Remote motorn anslutning
Engine Name	Motorn namn
Engine Port	Motorn Port
Enter the Name or IP Address of the MCEBuddy engine you want to connect to	Ange namnet eller IP-adressen för den MCEBuddy motorn som du vill ansluta till
Enter the TCP Port number of the MCEBuddy Engine you want to connect to	Ange TCP-portnumret för MCEBuddy motor du vill ansluta till
Enter the TCP Port number of the MCEBuddy Engine you want to connect to (1 to 63355)	Ange TCP-portnumret för MCEBuddy motor du vill ansluta till (1 till 63355)
Invalid Name/Port	Ogiltigt namn/Port
Please enter a valid Engine Name and Engine Port Number	Ange ett giltigt motorn namn och portnummer som motorn
Error Stopping Engine	Fel stoppar motorn
Unable to stop MCEBuddy engine, settings may not be saved. Do you want to continue?	Det gick inte att stoppa MCEBuddy motor, inställningar kan inte sparas. Vill du fortsätta?
Unable to communicate with engine. Settings have NOT been saved.	Det går inte att kommunicera med motorn. Inställningar har inte sparats.
Communication Error	Kommunikationsfel
Engine not stopped. Settings have NOT been saved.	Motorn inte stoppas. Inställningar har inte sparats.
Unable To Save Settings	Det gick inte att spara inställningarna
Unable to communicate with engine. UPnP settings have not been updated	Det går inte att kommunicera med motorn. UPnP settings har inte uppdaterats
Audio delay	Ljudfördröjning
Enter a value in seconds (positive or negative) here to shift the audio relative to the video.\r\nUse this to resync the audio with the video, if they are out of sync after conversion.\r\nA positive value will delay the audio (i.e. video ahead of audio) and a negative value will advanced the audio (i.e. audio ahead of video).\r\nE.g. -1.5	Ange ett värde i sekunder (positiva eller negativa) här för att flytta ljud i förhållande till video.\r\nUse detta för att resync ljud med video, om de är synkroniserad efter conversion.\r\nA positivt värde kommer att försena ljud (dvs. video före ljud) och ett negativt värde kommer avancerade ljud (dvs. ljud före video).\r\nE.g. 1,5
Media info	Media info
Click here to get media properties for selected files	Klicka här för att få Medieegenskaper för markerade filer
Save information	Spara information
Add information	Lägg till information
Shows a preview of the custom filename and path	Visar en förhandsgranskning av det anpassade filnamn och sökväg
Invalid Filename Pattern	Ogiltigt filnamn mönster
TVDB Series ID	TVDB rad-ID
IMDB Series ID	IMDB-serien-ID
Original title	Original-titel
Corrected title	Korrigerade titel
Enter the TVDB Series ID you want to use for downloading show information.\r\nIf the Original title box is empty, this will be applied to all shows selected by this conversion task.	Ange TVDB rad-ID du vill använda för att ladda ner Visa information.\r\nIf rutan ursprungliga titel är tom, detta kommer att tillämpas på alla visar valts av denna Konverteringsuppgift.
Enter the IMDB Movie ID you want to use for downloading movie information.\r\nIf the Original title box is empty, this will be applied to all shows selected by this conversion task.	Ange IMDB film ID du vill använda för att ladda ner filmen information.\r\nIf ursprungliga titelrutan är tom, detta kommer att tillämpas på alla visar valts av denna Konverteringsuppgift.
Internet Lookup Title and Metadata Correction	Internet-sökning titel och Metadata korrigering
Click here to add another row to match and correct titles and series id.\r\nIf you want to use the same corrected title or series id for all shows converted by this conversion task,\r\nleave the original title blank on the first row and you should NOT add a second row.	Klicka här för att lägga till en annan rad för att matcha och korrekta titlar och serien id.\r\nIf du vill använda samma rättade titeln eller serie-id för alla visar omvandlas av denna Konverteringsuppgift, \r\nleave den ursprungliga titel tomt på första raden och du bör inte lägga till en andra rad.
Enter pattern to match show/series titles for correction (e.g. Simpson* will replace all titles that have a show title starting with Simpson)\r\nPrefix pattern with ~ to skip the match (e.g. *.*;~Simpson* will correct all show titles except those that start with Simpson)\r\nSeparate multiple patterns with ; (e.g. Simpson*;House*) or (e.g. Simpson*;NCIS*;~NCIS Miami*)\r\n\r\nNOTE: Leave this box empty if you want to apply the corrected title or series id to ALL files being processed by this conversion task.\r\nIf leaving blank, you cannot add a second row.\r\n\r\nYou can use a regular expression to match the title by starting with regex:	Ange mönster för att matcha Visa/serien titlar för korrigering (e.g. Simpson * kommer att ersätta alla titlar som har ett Visa titel börjar med Simpson) \r\nPrefix mönster med ~ att hoppa över matchen (t.ex. *. *, ~ Simpson * kommer att korrigera visar alla titlar utom de som börjar med Simpson) \r\nSeparate flera mönster med; (t.ex. Simpson *;House*) eller (e.g. Simpson *;NCIS*; ~ NCIS Miami *) \r\n\r\nNOTE: lämnar du rutan tom om du vill använda rättade titeln eller serie-id för alla filer som bearbetas av denna omvandling task.\r\nIf lämna tomt, du inte kan lägga till en andra row.\r\n\r\nYou kan använda ett reguljärt uttryck för att matcha titeln genom att börja med regex:
Enter the new/corrected title you want to use for downloading additional information from the internet.\r\nIf the Original title box is empty, this will be applied to all shows selected by this conversion task.\r\n\r\nYou can use a regular expression to correct the title by starting with regex:	Ange den nya/korrigerade rubrik du vill använda för att hämta ytterligare information från internet.\r\nIf ursprungliga titelrutan är tom, detta kommer att tillämpas på alla visar valts av denna omvandling task.\r\n\r\nYou kan använda ett reguljärt uttryck för att korrigera titeln genom att börja med regex:
For each row, please enter the Original title to match the show name AND either a Corrected title or a TVDB/IMDB Series ID	För varje rad, skriv in den ursprungliga titeln för att matcha namnet Visa och antingen en rättad rubrik eller en TVDB/IMDB-ID
Please enter either a Corrected title or a TVDB/IMDB Series ID	Ange antingen en rättad rubrik eller en TVDB/IMDB-ID
Enable this if you want MCEBuddy to put the converted file in the source directory\r\nif the destination path is unavailable. (e.g. Network failure or mapping failure)	Aktivera detta om du vill MCEBuddy att sätta den konverterade filen i Källkod directory\r\nif Målsökvägen är inte tillgänglig. (t.ex. nätverk eller mappning)
Fallback to source path	Återgå till källsökvägen
Used to increase or decrease the volume of the\r\nrecording while converting.\r\n1 is normal, anything below will reduce it, anything\r\nhigher will increase it.	Används för att öka eller minska volymen av the\r\nrecording medan converting.\r\n1 är normalt, något nedan kommer att minska det kommer anything\r\nhigher att öka det.
Archive folder	Arkivmapp
Change the location of the archive folder.\r\nLeave empty to use the default 'MCEBuddyArchive' folder in the original directory.	Ändra platsen för Arkiv folder.\r\nLeave tom att använda standardmappen "MCEBuddyArchive" i den ursprungliga katalogen.
Monitor subdirectories	Övervaka underkataloger
Check this box to also monitor all directories within the Monitor path	Markera den här kryssrutan även övervaka alla kataloger inom Monitor path
Click here to show MCEBuddy status	Klicka här för att visa MCEBuddy status
MCEBuddy service not connected	MCEBuddy service inte ansluten
MCEBuddy idle	MCEBuddy inaktiv
conversions in progress	konverteringar pågår
MCEBuddy stopped	MCEBuddy stoppas
Sync converted files	Synkronisera konverterade filer
Check this option if you want MCEBuddy to keep the converted files in sync with the original files.\r\ni.e. When the original files are deleted by the user, the corresponding converted files are also deleted.\r\n\r\nNOTE: MCEBuddy only monitors original files in the monitor locations folders and ONLY while the engine is running.\r\nMCEBuddy will not be able to track user deleted files while the engine is stopped.	Markera det här alternativet om du vill MCEBuddy att hålla de konverterade filerna i synk med det ursprungliga files.\r\ni.e. När de ursprungliga filerna tas bort av användaren, motsvarande konverterade filer är också deleted.\r\n\r\nNOTE: MCEBuddy bara övervakar de ursprungliga filer i mapparna monitor platser och bara när motorn är running.\r\nMCEBuddy inte kommer att kunna spåra bort användarfiler medan motorn stoppas.
Do you wish MCEBuddy to delete each converted file when the original file has been deleted?	Vill du MCEBuddy att ta bort varje konverterad fil när filen har tagits bort?
Confirm sync conversions?	Bekräfta synkronisering konverteringar?
Are you sure you DO NOT want to remove commercials from the converted video and only keep the EDL file?	Är du säker på att du inte vill ta bort reklam från den konverterad videon och bara hålla filen Europeiska?
ShowAnalyzer is not responding. Please the reboot system or reinstall ShowAnalyzer.	ShowAnalyzer svarar inte. Vänligen starta om systemet eller installera om ShowAnalyzer.
ShowAnalyzer Not Responding	ShowAnalyzer svarar inte
Make sure you press 'Start' after closing this window, otherwise Scheduling and Wake will not work.	Se till att du trycker på "Start" efter detta fönster stängs, annars schemaläggning och Wake fungerar inte.
Enabling Scheduling and Wake	Möjliggör schemaläggning och Wake
Passwords do not match	Lösenorden matchar inte
Password error	Lösenord fel
Adding subtitles and chapters to file	Att lägga till undertexter och kapitel filen
Send eMail if unable to download series information	Skicka e-post om det inte går att ladda ner serien information
Check this box if you want this conversion task to only process files from specific monitor locations.\r\nIf unchecked each conversion task will process files from all monitor locations (including new ones added later).	Markera denna ruta om du vill att denna Konverteringsuppgift att endast bearbeta filer från specifika monitor locations.\r\nIf okontrollerat varje Konverteringsuppgift kommer att bearbeta filer från alla monitor platser (inklusive nya läggas till senare).
Select Monitor Locations	Välj Monitor platser
Select atleast one Monitor Location name	Välj iallafall en Monitor platsnamnet
You have selected all the current Monitor Locations.\r\nDo you want this conversion task to automatically process any new Monitor Locations added in future?	Du har valt alla de nuvarande Monitor Locations.\r\nDo du vill ha denna Konverteringsuppgift att bearbeta automatiskt alla nya Monitor platser läggs i framtiden?
New monitor locations	Nya monitor platser
Invalid selection	Ogiltig markering
Channel name match	Kanal namn match
Enter pattern to match the channel name for this task (e.g. ABC* will convert all files that recorded on a channel name starting with ABC)\r\nPrefix pattern with ~ to skip the match (e.g. *;~ABC* will process all channels except those that start with ABC)\r\nSeparate multiple patterns with ; (e.g. ABC*;TBS*) or (e.g. ABC*;Fox*;~Fox4*)\r\n\r\nYou can use regular expressions to match the pattern by starting with regex:	Ange mönster för att matcha kanalnamnet för denna uppgift (e.g. ABC * kommer att konvertera alla filer som spelats in på en Kanalnamn börjar med ABC) \r\nPrefix mönster med ~ att hoppa över matchen (t.ex. *, ~ ABC * kommer att bearbeta alla kanaler utom de som börjar med ABC) \r\nSeparate flera mönster med; (e.g. ABC *;TBS*) eller (e.g. ABC *;Fox*; ~ Fox4 *) \r\n\r\nYou kan använda reguljära uttryck för att matcha mönstret genom att börja med regex:
Clear history	Rensa historik
Click this button to clear the history of all converted files.\r\nThis is cause MCEBuddy to reconvert all files being monitored.	Klicka på knappen Rensa alla konverterade files.\r\nThis historia är orsaka MCEBuddy att konvertera om alla filer som övervakas.
Are you sure you want to clear the history of all conversions?\r\nThis will cause MCEBuddy to reconvert all files being monitored.	Är du säker du vill rensa alla omvandlingar historia? \r\nThis kommer att orsaka MCEBuddy att konvertera om alla filer som övervakas.
Show history	Visa historia
Click this button to show the history of all converted files.	Klicka här för att Visa historien av alla konverterade filer.
History of Converted Files	Historia av konverterade filer
Unable to communicate with engine.	Det går inte att kommunicera med motorn.
Extracting streams	Extrahera strömmar
Fallback muxing streams	Fallback muxing strömmar
Remuxing TiVO file	Remuxing TiVO fil
Enter your 10 digit TiVO MAK key to convert and process TiVO recordings	Ange ditt 10-siffriga TiVO MAK nyckel till omvänd och bearbeta TiVO-inspelningar
Invalid TiVO MAK Key	Ogiltig TiVO MAK nyckel
The TiVO MAK key should be 10 digits	TiVO MAK nyckeln bör vara 10 siffror
Version mismatch. Please ensure that the MCEBuddy client and engine are running the same version.	Versionsmatchningsfel. Se till att MCEBuddy klienten och motorn kör samma version.
Error retrieving Event Logs	Fel vid hämtning av händelseloggar
Unable to get Event Log Entries from the MCEBuddy engine.	Det går inte att få händelseloggposter från motorns MCEBuddy.
PAUSED: Check conversion schedule	PAUSADE: Kontrollera konvertering schema
Logging	Loggning
Folder Management	Broschyren företagsledning
Processor Management	Processhantering
Expert Settings	Expertinställningar
System Settings	Systeminställningar
Click here to change additional settings (for experts only)	Klicka här om du vill ändra ytterligare inställningar (för endast för experter)
Failed folder	Misslyckade mapp
Location of the folder that hold the original files for failed conversions.	Platsen för mappen som innehåller de ursprungliga filerna för misslyckade konverteringar.
Move original file on failure	Flytta originalfilen på fel
Check this to move the original file to a separate folder if the conversion fails.	Markera för att flytta den ursprungliga filen till en separat mapp om konverteringen misslyckas.
Check this to limit the number of logical processors that MCEBuddycan use.\r\nEach check box below corresponds to an available logical processor.	Markera för att begränsa antalet logiska processorer som MCEBuddycan use.\r\nEach kryssrutan nedan motsvarar en tillgänglig logisk processor.
Each box represents logical processors from 1 to 16 respectively.\r\nChecking a box allows MCEBuddy to use that processor.	Varje ruta representerar logiska processorer från 1 till 16 respectively.\r\nChecking en låda tillåter MCEBuddy att använda som en processor.
Each box represents logical processors from 17 to 32 respectively.\r\nChecking a box allows MCEBuddy to use that processor.	Varje ruta representerar logiska processorer från 17 till 32 respectively.\r\nChecking en låda tillåter MCEBuddy att använda som en processor.
Select atleast one processor to use	Välj iallafall en processor att använda
Invalid Configuration	Ogiltig konfiguration
Comskip path	Comskip väg
If you want to use a custom version of Comkip (e.g. donator version)\r\nthen enter the path of the comskip installation here.\r\nLeave blank to use the default comskip that comes with MCEBuddy.	Om du vill använda en anpassad version av Comkip (e.g. Gåvogivaren version) \r\nthen ange sökvägen till den comskip installation here.\r\nLeave tom att använda standard-comskip som kommer med MCEBuddy.
Miscellaneous	Diverse
Ignore copy protection	Ignorera kopieringsskydd
Check this to ignore the copy protection flag on video file while converting.\r\nNOTE: MCEBuddy cannot bypass encryption, this only helps if a file is incorrectly\r\ntagged as copy protected when it is NOT encrypted.	Kolla här om du vill ignorera kopieringsskydd flaggan på videofilen medan converting.\r\nNOTE: MCEBuddy kan inte kringgå krypteringen, bidrar detta endast om en fil är incorrectly\r\ntagged som kopia skyddad när det inte är krypterad.
Use recycle bin	Använda papperskorgen
Check this to use the recycle bin when files are deleted by MCEBuddy	Markera för att använda papperskorgen när filer tas bort av MCEBuddy
Poll period	Poll period
This is how often MCEBuddy scans the Monitor Tasks Locations for new files.\r\nThe interval is specified in seconds.	Detta är hur ofta MCEBuddy skannar de övervaka aktiviteter platser för nya files.\r\nThe intervall anges i sekunder.
Server port	Serverport
This is the TCP port MCEBuddy uses to communicate with the remote engine.\r\nWhen UPnP is enabled, MCEBuddy will automatically add this port to the Windows Firewall\r\nand UPnP gateway to allow access from the internet on this port.	Detta är den TCP-port som MCEBuddy använder för att kommunicera med den avlägsna engine.\r\nWhen UPnP är aktiverad, MCEBuddy automatiskt lägga till denna port till Windows Firewall\r\nand UPnP-gateway att tillåta åtkomst från internet på denna port.
Hang period	Hänga period
Enter the number of seconds that MCEBuddy will wait for a response from the\r\nunderlying application before terminates the application as hung.\r\nEnter 0 to disable hang detection.	Ange antalet sekunder som MCEBuddy kommer att vänta på ett svar från the\r\nunderlying-program innan avslutar programmet som hung.\r\nEnter 0 för att inaktivera upptäckt av hänga.
Subtitle commercial cut sync	Subtitle kommersiella skär sync
This parameter is used when the subtitles go progressively out of sync after each commercial segment is removed from the video.\r\nThis setting is used to bring the subtitles back into sync with the video.\r\nEach time the video commercial is cut out, the subtitles are time shifted by this amount (+ve or -ve in seconds).	Den här parametern används när undertexter gå gradvis osynkat efter varje kommersiella segment tas bort från den video.\r\nThis inställningen används för att få undertexter tillbaka i synk med video.\r\nEach tiden videon kommersiella skärs ut, undertexter tid skiftat av detta belopp (+ ve eller -ve i sekunder).
Invalid poll period	Ogiltig poll period
Invalid server port	Ogiltig Serverport
eMail Subject Customization	e-post angående anpassning
Use this section to customize the subject of eMail sent by MCEBuddy on the various conversion events listed below.\r\nRefer to the documentation, custom commands for user defined variables.\r\ne.g. Show %showname% for file %originalfilename% conversion successful using task %taskname%\r\nNOTE: Not always will all the data be available in the custom commands.\r\nLeave blank to use default subject lines.	Användning här kan du anpassa föremål för e-post skickas av MCEBuddy på de olika konvertering händelserna visas below.\r\nRefer i dokumentationen, anpassade kommandon för användardefinierade variables.\r\ne.g. Visa % showname % % originalfilename % filkonvertering framgångsrik med aktiviteten % taskname%\r\nNOTE: inte alltid alla data blir tillgängliga i den anpassade commands.\r\nLeave tom att använda standard ämnesrader.
Success	Framgång
Failed	Misslyckades
Cancelled	Inställd
Download fail	Hämta misslyckas
Limit processor utilization	Gräns processoranvändning
Check this to limit the number of logical processors that MCEBuddy can use.\r\nEach check box below corresponds to an available logical processor.	Kontrollera motsvarar att begränsa antalet logiska processorer som MCEBuddy kan use.\r\nEach kryssrutan nedan en tillgänglig logisk processor.
Custom profile	Anpassad profil
If you have a custom profiles.conf file that you want to use instead of the\r\none that comes with MCEBuddy, enter the path to the file here.\r\n\r\nNOTE: MCEBuddy constantly updates profiles.conf to provide bug fixes,\r\nenhancements and performance improvements which you will miss out\r\non if you use this feature.	Om du har en egen profiles.conf-fil som du vill använda i stället för the\r\none som medföljer MCEBuddy, ange sökvägen till filen here.\r\n\r\nNOTE: MCEBuddy ständigt uppdateringar profiles.conf att ge bugg fixar, förbättringar av \r\nenhancements och prestanda som du kommer att sakna out\r\non om du använder denna funktion.
Invalid custom profiles.conf	Ogiltig anpassade profiles.conf
Suspend on battery	Avbryta på batteri
Suspend conversions when the computer switches to battery power	Avbryta omvandlingar när datorn växlar till batteridrift
MCEBuddy added a video conversion to the queue	MCEBuddy lagt till en video konvertering till kön
Queue	Kö
Refer to documentation on using custom commands in custom eMail subjects	Dokumentationen om hur du använder anpassade kommandon i anpassad e-ämnen
Could not copy information to Clipboard, please try again.	Kunde inte kopiera informationen till Urklipp, vänligen försök igen.
Error copying to Clipboard	Fel kopiera till Urklipp
Copy to clipboard	Kopiera till Urklipp
Reconvert files	Konvertera om filer
Are you sure you want to reconvert the selected files?	Är du säker du vill konvertera om de markerade filerna?
Select the files you want to reconvert and then click this button.\r\nIf the original files are still being monitored by MCEBuddy they will be queued for reconversion.	Markera de filer du vill konvertera om och klicka sedan på denna button.\r\nIf den ursprungliga filer övervakas fortfarande av MCEBuddy de kommer att vara kö för omställning.
Time taken to convert	Tid det tar att konvertera
Network authentication	-Nätverksautentisering
Click the button to enter the network shares credentials.\r\nThis authentication is used when files are added via the Add button on the main window\r\nor dragged and dropped from a network share into the conversion status box on the main window.	Klicka på knappen för att ange nätverksverifiering aktier credentials.\r\nThis används när filer läggs via knappen Lägg till på den huvudsakliga window\r\nor dra och släpp från en nätverksresurs i rutan konvertering status i huvudfönstret.
Skip reconversion	Hoppa över omställning
Do not reconvert the video if a converted file already exists in the destination directory.	Konvertera inte om videon om en konverterad fil redan finns i målkatalogen.
The expected filename for the converted video (not the original video filename) is compared with the filenames in the destination directory.\r\nIf the converted file exists, the file will not be reconverted and it will be assumed to be a successful conversion.\r\nThis is useful if the same show/episode is being recorded on multiple times and you don't want to reconvert them.\r\n\r\nNOTE: This option is ignored for videos that are added manually using the add button or dragging and dropping	Förväntade arkivnamnen för den konverterade videon (inte det ursprungliga video filnamnet) jämförs med filnamnen i destination directory.\r\nIf konverterade filen finns, filen kommer inte att verksamheter och det kommer att antas vara en framgångsrik conversion.\r\nThis är användbart om samma Visa/episod spelas på flera gånger och du inte vill konvertera om them.\r\n\r\nNOTE: Det här alternativet ignoreras för videor som läggs till manuellt med hjälp av knappen Lägg till eller dra och släppa
If enabled, skip reconversion will also check the history file for past conversions.\r\nThe expected filename for the converted video (not the original video filename) is compared with the filenames in the history file.\r\nIf the to be converted filename (including path) matches any of the already converted filenames (including paths) in the history file,\r\nthe file will not be reconverted and it will be assumed to be a successful conversion.	Om aktiverad, skip omställning kommer att checka historikfilen för senaste conversions.\r\nThe arkivnamnen för den konverterade videon (inte det ursprungliga video filnamnet) jämförs med filnamnen i historia file.\r\nIf den vara konverterade filnamnet (inklusive sökväg) matchar någon av redan konverterad filnamnen (inklusive sökvägar) i historikfilen, \r\nthe filen kommer inte att verksamheter och det kommer att antas vara en lyckad konvertering.
Adding file to the iTunes library	Lägga till filen i iTunes-biblioteket
Add to iTunes	Lägg till iTunes
Check this box to automatically add the converted files to the iTunes library.\r\nThis only works with iTunes supported files (e.g. MP4, M4V, MP3 etc)	Kolla här om du vill lägga automatiskt till de konverterade filerna i iTunes library.\r\nThis fungerar bara med iTunes stöttat arkivera (e.g. MP4, M4V, MP3 etc)
Adding file to the WMP library	Lägga till filen i Windows Media Player-biblioteket
Library Management	Bibliotekshantering
Add to Windows Media Player	Lägga till i Windows Media Player
Check this box to automatically add the converted files to the WMP library.	Markera den här kryssrutan för att automatiskt lägga till de konverterade filerna till Windows Media Player-biblioteket.
Renaming and Sorting	Byta namn och sortering
Selection Filters	Urvalsfilter
Audio and Video	Ljud och Video
Subtitles and Chapters	Undertexter och kapitel
Skip copying original files	SKIP ursprungliga filkopiering
CHECK THIS BOX AT YOUR OWN RISK.\r\nDO NOT CHECK THIS BOX UNLESS YOU KNOW WHAT YOU ARE DOING.\r\nCheck this box to skip making a backup of original file (copying) while converting.	Kolla den här rutan på din egen RISK.\r\nDO inte kontrollera denna BOX om du vet vad du är DOING.\r\nCheck här du hoppa över att göra en säkerhetskopia av den ursprungliga filen (kopiering) vid konvertering.
CHECK THIS BOX AT YOUR OWN RISK.\r\nDO NOT CHECK THIS BOX UNLESS YOU KNOW WHAT YOU ARE DOING.\r\nCheck this box to skip making a backup of original file (copying) while converting.\r\nIf this is checked, the original file will not be preserved in case of an error.\r\nIt can also even lead to conversion failures or other unforeseen conversion issues.	Kolla denna rutan på din egen RISK.\r\nDO inte markera denna ruta om du inte vet vad du är DOING.\r\nCheck detta att hoppa över att göra en säkerhetskopia av den ursprungliga filen (kopiera) medan converting.\r\nIf detta är ikryssat, den ursprungliga filen inte bevaras vid en error.\r\nIt också även kan leda till konvertering misslyckanden eller andra oförutsedda konvertering frågor.
Are you sure you want to do this?	Är du säker på att du vill göra detta?
Media Information Management	Media Information Management
Force show type	Kraft visar typ
Set this to force treating the video recording as a Movie or TV Series.\r\nThis will change the way additional information (metadata) about the recording is downloaded from the internet.\r\nMovie - Treat the recording as movie\r\nSeries - Treat the recording as a TV Series\r\nSports - Treat the recording as a Sports show\r\nDefault - Use the default information available in the recording metadata to determine Movie or TV Series	Ställ in den till tvinga behandla videoinspelning som en film eller TV-Series.\r\nThis kommer att ändra hur ytterligare information (metadata) om inspelningen är hämtat från internet.\r\nMovie - behandla inspelningen som movie\r\nSeries - behandla inspelningen som en TV-Series\r\nSports - behandla inspelningen som en sport show\r\nDefault - Använd standardinformationen i inspelningen metadata att bestämma film eller TV-serie
Show type	Visa typ
Select this to filter the type of recordings being converted.\r\n\r\nMovies - select this to convert if the show type is Movie.\r\nShows - select this to convert if the show type is NOT a Movie.\r\nSports - select this to convert if the show type is Sports.\r\n\r\nNOTE: Show type is read from the recording metadata.\r\nOnly some recordings support show type metadata such as WTV and\r\nrecordings with supporting metadata files (XML/ARG etc).	Välj denna för att filtrera vilka inspelningar som converted.\r\n\r\nMovies - Välj denna för att konvertera om Visa typen är Movie.\r\nShows - Välj denna för att konvertera om Visa typen inte är en Movie.\r\nSports - Välj denna för att konvertera om Visa typen är Sports.\r\n\r\nNOTE: Visa typ läses från den inspelning metadata.\r\nOnly några inspelningar stödja Visa typ metadata som WTV and\r\nrecordings med stöd för metadata filer ()XML/ARG etc).
This box shows all the files in queue for conversion.\r\nDrag and drop files here or press the Add button to add files to the conversion queue	Den här rutan visar alla filer i kö för conversion.\r\nDrag och släpp filer här eller tryck på knappen Lägg till för att lägga till filer till konverteringskön
Conversion	Konvertering
Files	Filer
Click this button to open or close the Advanced Settings section	Klicka här för att öppna eller stänga avdelningen avancerade inställningar
Running custom commands	Köra anpassade kommandon
Trimming video recording	Trimning video inspelningen
Insert at top of queue	Infoga överst i kö
By default, new conversions are added to the bottom (end) of the conversion queue.\r\nIf this box is checked, any new conversions added by this task will be added to the\r\nbeginning (top) of the conversion queue.	Som standard läggs nya konverteringar till botten (slutet) av konvertering queue.\r\nIf detta är ikryssat, någon ny omvandlingar som lagts till av denna uppgift kommer att läggas till the\r\nbeginning (överst) av konverteringskön.
Add subtitles and chapters	Lägga till undertexter och kapitel
Enable this option to add any extracted subtitles and chapters to the converted video.\r\nEach chapter marks the end of a commercial. This only works with supported formats (e.g. MKV, MP4).\r\n\r\nNOTE: Some players and older TV's don't support embedded subtitles and chapters.\r\nIf you're unable to playback the converted video's, try turning this option off.	Aktiverar alternativet att lägga till alla extraherade undertexter och kapitlen i konverterade video.\r\nEach kapitel markerar slutet på en kommersiell. Detta fungerar bara med format som stöds (t.ex. MKV, MP4).\r\n\r\nNOTE: vissa spelare och äldre TV stöder inte inbäddade undertexter och chapters.\r\nIf du inte kan uppspelning konverterade videon, prova om du inaktiverar det här alternativet.
Select best soundtrack	Välj bästa soundtrack
If the original video has multiple soundtracks, this option tells MCEBuddy to select the most appropriate and primary soundtrack.\r\nIf you want a specific language soundtrack, make sure you enter the language name or code in the Audio Language box.\r\nCheck this box if you're hearing the wrong soundtrack in your converted file.\r\n\r\nUncheck this box if you want MCEBuddy to retain all the soundtracks from the original video in the converted file when possible.\r\nNOTE:Some profiles do not support multiple soundtracks, in which case this setting has no effect.	Om den ursprungliga videon har flera ljudspår, detta alternativ berättar MCEBuddy att välja den mest lämpliga och primära soundtrack.\r\nIf du vill att ett visst språk soundtrack, se till att du anger språknamnet eller kod i ljudspråk box.\r\nCheck denna ruta om du höra fel soundtracket i din konverterade file.\r\n\r\nUncheck denna ruta om du vill MCEBuddy att behålla alla ljudspår från den ursprungliga videon i den konverterade filen när möjligt. \r\nNOTE: några profiler stöder inte flera ljudspår, i vilket fall den här inställningen har ingen effekt.
Enable remote access	Aktivera fjärråtkomst
This creates an exception in the windows firewall for MCEBuddy application and the port.\r\nThis is required if you have windows firewall enabled and want to use UPnP, the remote client\r\nor access the engine using an IP address.\r\n\r\nNOTE: If you have a custom firewall, this may not work, you will need to manually create an\r\nexception for MCEBuddy service and the port.	Detta skapar ett undantag i windows-brandväggen för MCEBuddy tillämpning och port.\r\nThis krävs om du har windows-brandväggen är aktiverad och vill använda UPnP, remote client\r\nor tillgång motorn med en IP-address.\r\n\r\nNOTE: om du har en egen brandvägg, detta kanske inte fungerar, måste du manuellt skapa an\r\nexception för MCEBuddy service och hamnen.
Unable to communicate with engine. Firewall exception settings have not been updated.	Det går inte att kommunicera med motor. Undantag brandväggsinställningar har inte uppdaterats.
Detect and optimize video quality	Upptäcka och optimera video kvalitet
When enabled, MCEBuddy will optimize the video processing options by trying to detect the video source type.\r\nThis can improve the quality of the converted video significantly if correctly detected.\r\n\r\nNOTE: It does this by trying to detect the video source type (interlaced, progressive or telecine).\r\nIf it is able to detect the video source type, it will override the corresponding parameters in the profile.\r\nTurn this option off if you are facing issues with converted video quality or want to use the default profile parameters.	När aktiverad MCEBuddy optimerar alternativen video-bearbetning genom att försöka upptäcka video källa type.\r\nThis kan förbättra kvaliteten på den konverterade videon betydligt om korrekt detected.\r\n\r\nNOTE: det gör detta genom att försöka upptäcka vilken videokälla (interlaced, progressiva eller telecine).\r\nIf är det möjligt att upptäcka vilken videokälla, åsidosätter motsvarande parametrar i profile.\r\nTurn detta alternativ off om du står inför problem med konverterade video kvalitet eller vill använda den förvalda profil parametrar.
Are you sure you want to delete this task?	Är du säker du vill ta bort aktiviteten?
Delete Task	Ta bort uppgift
Enter the new task name	Ange det nya uppgiftsnamnet
Rename Task	Byt namn på uppgiften
MCEBuddy PAUSED	MCEBuddy stannade
idle	Idle
PAUSED	PAUSAD
Frame rate	Bildhastighet
Enable this to set a custom framerate (FPS) for the converted video.\r\nYou may need to set this while converting video formats (e.g. PAL to NTSC)\r\nor for devices which support only specific framerates.\r\n\r\nE.g.: 25\r\nE.g.: 30000/1001	Aktivera det här att ställa in en anpassad framerate (FPS) för den konverterade video.\r\nYou kan behöva ställa in detta vid konvertering av videoformat (e.g. PAL till NTSC) \r\nor för enheter som stöder endast viss framerates.\r\n\r\nE.g.: 25\r\nE.g.: 30000/1001
Skip remuxing files	Skippa remuxing filer
CHECK THIS BOX AT YOUR OWN RISK.\r\nDO NOT CHECK THIS BOX UNLESS YOU KNOW WHAT YOU ARE DOING.\r\nCheck this box to skip remuxing the original file to a TS file while converting.\r\nIf this is checked, some functions like subtitle extraction or comskip may not work.\r\nIt can also even lead to conversion failures or other unforeseen conversion issues.	Kolla den här rutan på din egen RISK.\r\nDO inte kontrollera detta fält om du vet vad du är DOING.\r\nCheck här om du vill hoppa remuxing den ursprungliga filen till en TS fil medan converting.\r\nIf här är markerat, vissa funktioner som underrubrik utvinning eller comskip kan inte work.\r\nIt också även kan leda till konvertering misslyckanden eller andra oförutsedda konvertering frågor.
CHECK THIS BOX AT YOUR OWN RISK.\r\nDO NOT CHECK THIS BOX UNLESS YOU KNOW WHAT YOU ARE DOING.\r\nCheck this box to skip remuxing the original file to a TS file while converting.	Kolla den här rutan på din egen RISK.\r\nDO inte kontrollera denna BOX om du vet vad du är DOING.\r\nCheck här du hoppa remuxing den ursprungliga filen till en TS fil vid konvertering.
Monitor converted videos	Övervaka konverterade videoklipp
By default Monitor Locations will ignore files that have already been converted.\r\nCheck this box if you also want to monitor converted files in the Monitor Path.\r\nCAUTION: This can lead to an infinite conversion loop of converted files if not configured properly.\r\n\r\nThis can be useful when you are specifying the output directory of a conversion task\r\n(converted file) as the Monitor Path of a Monitor Location and linking the\r\nMonitor Location to another conversion task.	Som standard Monitor platser kommer att ignorera filer som redan har converted.\r\nCheck denna ruta om du också vill att övervaka konverterade filer i Monitor Path.\r\nCAUTION: detta kan leda till en oändlig konvertering loop av konverterade filer om inte konfigurerade properly.\r\n\r\nThis kan vara användbar när du anger utdatakatalogen av en konvertering task\r\n (konverterade filen) som Monitor sökväg till en plats i Monitor och länka the\r\nMonitor Plats till en annan omvandlingen aktivitet.
CHECK THIS BOX AT YOUR OWN RISK.\r\nDO NOT CHECK THIS BOX UNLESS YOU KNOW WHAT YOU ARE DOING.\r\nBy default Monitor Locations will ignore files that have already been converted.\r\nCheck this box if you also want to monitor converted files in the Monitor Path.	Kolla den här rutan på din egen RISK.\r\nDO inte kontrollera denna BOX om du vet vad du är DOING.\r\nBy Monitor standardplatser kommer att ignorera filer som redan har converted.\r\nCheck denna ruta om du också vill att övervaka konverterade filer i sökvägen Monitor.
Hardware encoding	Hårdvara-kodning
Check this box to use hardware encoding when available to convert videos.\r\nThis can speed up the conversion significantly and reduce the CPU utilization\r\nbut it can result in slightly lower quality videos.\r\n\r\nUncheck this box if you're facing conversion or quality issues.	Kolla här om du vill använda hårdvara-kodning när tillgängliga att konvertera videos.\r\nThis kan påskynda omvandlingen betydligt och minska CPU utilization\r\nbut kan det resultera i något lägre kvalitet videos.\r\n\r\nUncheck detta fält om du står inför ombyggnad eller kvalitetsfrågor.
Do not overwrite files	Inte skriva över filer
When this box is checked, the destination file will not be overwritten if it already exists.\r\nInstead a new file will be created with a unique number added to the end of the filename.	När rutan är markerad, kommer filen inte skrivas om det redan exists.\r\nInstead en ny fil kommer att skapas med ett unikt nummer läggs till i slutet av filnamnet.
Re-monitor recorded videos	Nytt övervaka inspelade videor
By default, once a source file (Recorded video) has been converted,\r\nthe monitor history will track the filename and not queue the same files again.\r\n\r\nEnable this option to ignore the history and monitor all files and add them to\r\nthe conversion queue, even if they have already been converted.\r\n\r\nThis can be useful sometimes, if the recording software does not generate a\r\nunique filename for each episode/show. It is reccomended to use the\r\nDelete original file option in the Settings page when using this option to avoid\r\nan infinite conversion loop.	Som standard när en källfil (inspelad video) har konverterats, \r\nthe monitor historia kommer att spåra filnamnet och inte kön på samma filer again.\r\n\r\nEnable detta alternativ för att ignorera historien och övervaka alla filer och lägga till dem to\r\nthe konverteringskön, även om de redan har converted.\r\n\r\nThis kan vara bra ibland, om inspelningsprogrammet inte genererar a\r\nunique filnamn för varje episod/Visa. Det rekommenderas att använda the\r\nDelete ursprungliga filen alternativ i inställningar när du använder alternativet till avoid\r\nan oändlig konvertering loop.
Recommendation	Rekommendation
To avoid an infinite conversion loop, it is recommended to setup your Monitor search pattern in a way such as to ensure that the converted files are not being monitored by this Monitor task.	För att undvika en oändlig konvertering loop, rekommenderas det att installera din Monitor Sök mönster på ett sätt som att se till att de konverterade filerna inte övervakas av denna Monitor uppgift.
CHECK THIS BOX AT YOUR OWN RISK.\r\nDO NOT CHECK THIS BOX UNLESS YOU KNOW WHAT YOU ARE DOING.\r\nBy default Monitor Locations will not remonitor recorded videos that have been processed.\r\nCheck this box if you want to remonitor and reconvert the recorded videos.	Kolla denna rutan på din egen RISK.\r\nDO inte kontrollera denna BOX om du vet vad du är DOING.\r\nBy standard Monitor platser inte kommer antecknar inspelade videor som har varit processed.\r\nCheck här om du vill du antecknar och konvertera om det inspelade videor.
To avoid an infinite conversion loop, it is recommended that you enable Delete original file option in the Settings page.	För att undvika en oändlig konvertering loop, rekommenderas det att du aktiverar radera ursprungliga filen i sidan.
Prioritize air date matching	Prioritera luft datum matchande
MCEBuddy uses the episode name to match the series information\r\nwhile searching the internet. If that fails then it uses the original broadcast\r\nair date to match the metadata.\r\n\r\nCheck this box to use the original broadcast air date first and then the\r\nepisode name to match for the series information from the internet.\r\nThis can be useful in some cases when multiple seasons have the same\r\nepisode name. E.g. Americal Idol, Audition 1\r\n\r\nNOTE: Original broadcast air date is not always accurate set by the\r\nbroadcaster and sometimes the information on the internet is incorrect.\r\nUse this option only if the default option is not working for you.	MCEBuddy används namnet episod för att matcha den serie information\r\nwhile söka på internet. Om det misslyckas då det använder det ursprungliga broadcast\r\nair datumet för att matcha metadata.\r\n\r\nCheck rutan för att använda den ursprungliga broadcast luft dagen först och sedan the\r\nepisode namn att matcha för den serieinformationen från internet.\r\nThis kan vara användbart i vissa fall när flera säsonger har namnet same\r\nepisode. E.g. Americal Idol Audition 1\r\n\r\nNOTE: ursprungliga broadcast luft datum är inte alltid korrekt uppsättning av the\r\nbroadcaster och ibland information på internet är incorrect.\r\nUse detta alternativ endast om alternativet inte fungerar för dig.
Skip eMail body	Hoppa över e-kroppen
Check this option to use an empty body in the notification eMail.\r\nThis can be useful if you're using a SMS gateway for eMail notifications.	Kontrollera att alternativet att använda en tom kropp i anmälan eMail.\r\nThis kan vara användbart om du använder en SMS-gateway för e-postmeddelanden.
Selection based on Digital Right Management (DRM) is available\r\nonly when Rename without converting (Rename and move only) option is selected.\r\n\r\nAll - Selects all files for processing, irrespective of copy protection status\r\nProtected - Only select files which are copy protected\r\nUnprotected - Only select files which do not have copy protection	Urval baserat på digitala rätt Management (DRM) är available\r\nonly när döpa utan konvertering (byta namn på och flytta bara) alternativ är selected.\r\n\r\nAll - för att välja alla filer för bearbetning, oavsett kopieringsskydd status\r\nProtected - bara välja filer som är kopia protected\r\nUnprotected - bara välja filer som inte har kopieringsskydd
Download cover art	Hämta omslagsbilder
Enable this to download the cover art from the original video and internet if available.	Aktivera detta ladda ner omslaget från den ursprungliga video och internet om tillgängliga.
Are you sure you want to enter a Domain Name?\r\n\r\nUse this ONLY if you are using a Windows Domain Controller to manage your authentication.\r\nDo NOT use this if you are part of a Workgroup.\r\n\r\nIf you are unsure click NO.	Är du säker du vill ange en domän? \r\n\r\nUse detta endast om du använder en Windows-domänkontrollant för att hantera din authentication.\r\nDo inte använda detta om du är del av en Workgroup.\r\n\r\nIf du är osäker klickar du på Nej.
Configuration Warning	Konfiguration varning
Creates a folder called 'MCEBuddyArchive' where the original file is located\r\nand moves the orginal file in this directory after a successful conversion.\r\n\r\nThis folder name and location be changed below.	Skapar en mapp som heter "MCEBuddyArchive" där den ursprungliga filen är located\r\nand flyttar orginal filen i katalogen efter framgångsrika conversion.\r\n\r\nThis mappnamn och plats ändras nedan.
Monitoring	Övervakning
If you want to convert the EDL file into chapters, make sure you check the 'Add Subtitles and Chapters' option in Expert Settings.	Om du vill konvertera filen EDL in kapitlen, göra säker du check det "Lägga till undertexter och kapitlen" alternativet i Expert inställningar.
EDL to Chapters	EDL kapitel
