MCEBuddy does NOT use the currently logged in user to connect to network shares, it uses its own service account.  Be sure to specify the connection user information (MCEBuddy with a key icon)	currently QonoS user wej DanoHmeH mcebuddy rar network SoH, account chavmoH lumaq lach'eghDI' ngat.  connection user De' (mcebuddy icon ngaQHa'moHwI'mey) per be
Connection Reminder	connection Reminder
Description	description
Path	path
is invalid	invalid
Invalid Path	invalid Path
Please supply a task name	nuqneH, Qu' pong supply.
No name supplied	pagh pong supplied
Please enter the 3 digit language code of the Audio track or select <Default> or <Original>	nuqneH 3 digit Hol ngoq Audio ghoch pagh wIv <Default>joq <Original>'el
The 3 digit ISO code for the selected language\r\nMake sure this matches the language code for the audio track in the original recording.\r\nTo get the language code for the audio tracks in the original recorded file, add the file\r\nto the queue and right click on it. A pop up window will open showing the audio details\r\nwhich include the language codes for each audio track.	queue file\r\nto chel 'ej lugh click 3 digit iso ngoq wIv language\r\nmake be Hol ngoq audio ghoch original recording.\r\nto wej Hol ngoq audio ghoch original ta teywI', qul naQmey. cha' audio 'eb pop Ha' Qorwagh Hol ngoq audio Hoch ghoch DaH nobvam details\r\nwhich.
Invalid Language Code	Hol invalid ngoq
No destination directory provided, converted file will be placed in original video directory	DuHIvDI' pagh ghoch directory, lan bIDameH teywI' original video directory
A task name or section	Qu' pong 'ay' pagh
already exists\n\rPlease use another name	chonayta' latlh pong lo' exists\n\rplease
Duplicate Name	duplicate pong
Engine	jonta'
Tasks	ghIgh
Profile	qoghDu'DajDaq
disposing	dispose
Task name	Qu' pong
Give a unique name to this task	pong unique nob Qu'
Gives a short description for the selection conversion profile	ngaj description, selection conversion qoghDu'DajDaq nob
Click to select destination folder	click ghoch folder wIv
Destination	ghoch
Select the directory where the converted file will be placed.\r\nLeave this blank to keep the converted file in the same directory as the original video.	directory nuqDaq bIDameH teywI' ghaH placed.\r\nleave beQDaq blank pa'Dop DISHom bIDameH teywI' rap directory je original video wIv.
Max width	max width
This will limit the maximum width (in pixels) of the video for the converted file.\r\nTIP: Does not apply if the original file has a width smaller than this number.\r\nIf you want to keep your original video resolution move the slider all the way to the right.	'aqroS width (pixels) bIDameH file.\r\ntip video vuS: wej apply 'IjmeH width teywI' original smaller puS number.\r\nif slider pol original video resolution vIH Hoch mIw leghlaHbe' DaneH'a'.
Quality	laHlIj.
Ad remover	ad remover
None	pagh
Get series details from Internet	series details Suq vo' internet
Download additional details about the movie or series from the internet	Saturjaj details vIHtaHbogh movie series pagh download internet vo'
File name match	teywI' pong qul naQmey
Recording title match	recording title qul naQmey
Cancel	qIl
OK	LUQ
Rename without converting	rename Hutlh bIDameH
Check this option to only rename and copy the original files to the destination folder.\r\nWhen checked, conversion, trimming, audio/video processing and commercial removal will not be available.\r\n\r\nNOTE: Other functions like matching filters, extracting subtitles, saving metadata and commercial detection (saving EDL file)\r\nwill still be available with this option checked.\r\nIf you want to move instead of copy, check the Skip copying original option in Expert Settings on this page or select\r\nDelete original file in the main settings page.	conversion, trimming, audio ghap video processing 'ej commercial removal wej available.\r\n\r\nnote checked, DuH neH rename ghajHa'ghach original teywI' ghoch folder.\r\nwhen copy 'ej check: Qap latlh ghaytan filters subtitles metadata 'ej commercial detection, (edl teywI' pol) \r\nwill toD extracting qul naQmey lupoQ DuH checked.\r\nif instead of copy vIH DaneH'a', skip original DuH copying qaStaHvIS po' Settings page select\r\ndelete pagh original teywI' qaStaHvIS 'elbogh settings page check.
Rename and sort by video information	rename 'ej Segh video De'
Renames the converted file and places it in a new directory based on the show/series information when available\r\n(e.g. ShowName\\ShowName-SXXEYY-EpisodeName-RecordDate)	vupmoHmo' bIDameH teywI' renames 'ej 'ellaw' 'ej chu' directory waw' cha' ghap series De' HeghDI' available\r\n (e.g. showname\\showname-sxxeyy-episodename-recorddate)
Enter the username and password to access folders that are on a network drive or a different computer	username mu'wIj je naw' folders ghaH yItungHa', qaH network QaQ De'wI' pIm pagh
Organize by seasons	organize maqtagh
Organize folders by Showname and Season when available (Media Center/XBMC/Plex compatible naming convention)\r\n(e.g. Showname\\Season XX\\SXXEYY-Episode Name)	folders pong showname organize 'ej ghorgh yo' lupoQ (media botlh ghap xbmc ghap plex compatible 'oH pong convention) \r\n (e.g. showname\\season xx\\sxxeyy-episode pong)
Audio language	Hol audio
Advanced Settings	'Itlh Settings
General Settings	Sa' Settings
Conversion Task	conversion Qu'
Password	mu'wIj
Confirm Password	mu'wIj confirm
Domain / computer name	yer ghap De'wI' pong
<Optional> Enter if remote computer or network drive uses a Domain for authentication.\r\nDo NOT enter your workgroup here. Leave this blank if you're using a workgroup.	workgroup naDev wej 'el <optional>'el vaj yer lo' Hop De'wI' network pagh yItungHa', qaH QaQ authentication.\r\ndo. mej blank ta' vaj workgroup lo' SoH.
User name	user pong
Enter the username to access the remote computer or network drive	username yItungHa', qaH Hop De'wI' network pagh QaQ naw' 'el
Enter the password to access the remote computer or network drive	mu'wIj yItungHa', qaH Hop De'wI' network pagh QaQ naw' 'el
Network Connection User Credentials	network Connection User Credentials
Password Mismatch	mu'wIj Mismatch
Passwords do not match, please reenter the passwords	qul wej naQmey mu'wIj, nuqneH mu'wIj reenter
Hour	rep
Minute	tup
Wake	wake
Start	start
Resume	qa'
Pause	yev
Stop	mevyap
Language	Hol
Pause conversion tasks	yev conversion Qu'
Resume conversion tasks	conversion Qu' qa'
Please enter a valid time	nuqneH, poH valid 'el.
Invalid Time	invalid poH
Stop time is after Start time. Assuming the Stop time is during the next day, is that correct?	QoQ 'IH lIng poH qaSpu'DI' Start poH. jaj veb during QoQ 'IH lIng poH assuming 'e' lugh?
Time Check	poH Check
Only select this option if MCEBuddy has been converting your files reliably for an acceptable period of time. Do you wish MCEBuddy to delete each original file once it has been converted?	neH DuH wIv vaj teywI' bIDameH mcebuddy reliably acceptable puj poH. mcebuddy Hoch original teywI' delete wa'logh bIDameH 'oH DaneHchugh?
Confirm delete originals?	delete originals confirm?
MCEBuddy will monitor these directories for video files to convert automatically	nIb law' directories video teywI' bIDameH mIw automatically jIH mcebuddy
Conversion tasks	conversion Qu'
Delete original file	delete original teywI'
Deletes the original recording after a successful conversion	deletes original recording successful conversion qaSpu'DI'
Min age before conversion (hours)	min qantaHvIS pa' conversion (rep)
Minimum hours to wait before converting each file after the file is added to the queue	minimum rep pa' Hoch teywI' bIDameH qaSpu'DI' chel teywI' queue loS
Use this to change the language of the text on the screen	DanoHmeH bIngDaq ghItlh leghlu' jIHDaq chollaw'lI' Hol choH
Concurrent conversions	concurrent conversions
Number of simultaneous conversions MCEBuddy can start\r\nNOTE: You need large amounts of free disk space and processor time for more than 2 simultaneous conversions	simultaneous conversions mcebuddy mI' laH start\r\nnote: yIteb amounts gho Doqqu' tlhab poH logh processor 'ej nIS 2 puS conversions simultaneous
Logging level	logging patlh
Error	Qagh
Warning	warning
Information	De'
Debug	debug
Log conversion jobs	conversion jobs QonoS
Save a log file for each conversion in the \'logs\' directory where where MCEBuddy is installed\r\n(e.g. C:\\Program Files\\MCEBuddy2x\\logs)	QonoS teywI' Hoch conversion pol \'logs\ "nuqDaq nuqDaq mcebuddy installed\r\n (e.g. c:\\program files\\mcebuddy2x\\logs) directory
Allow sleep	Qong chaw'
If unchecked, it prevents the system from entering sleep while converting	vaj unchecked, pat bot 'oH vo' Qong Datoy'taHvIS bIDameH 'el
Stop at	qaStaHvIS mev
No new conversions would be started after this time	started conversions pagh chu' qaSpu'DI' porghvetlh
minute	tup
hour	rep
If checked MCEBuddy will wake the system from sleep\r\nat the specified Start time and enabled days of the week.	vaj vo' sleep\r\nat pat wake per Start poH 'ej jaj Hogh enabled, mcebuddy checked.
Start at	start DeSDu'
MCEBuddy will start new conversions between the Start and Stop time.\r\n\r\nThe Start time will be used for the enabled days of the week, whereas\r\nthe End time will be used either for the same day or\r\nfor the next day if the End time is after the Start time.	chu' conversions SabtaHbogh Start start 'ej time.\r\n\r\nthe Start lo' poH enable jaj Hogh mcebuddy, vo' vImughta' rap jaj or\r\nfor lo' whereas\r\nthe 'er'In ghaH poH qaSDI' vaj qaSpu'DI' Start poH van poH.
Delete	delete
Add	boq
Change	choH
Archive original file	archive original teywI'
Domain name	yer pong
Stops the monitor and conversion tasks and opens a page to configure MCEBuddy	jIH conversion 'ej Qu' mev 'ej page configure mcebuddy
Creates a folder called \'MCEBuddyArchive\' where the original file is located\r\nand moves the orginal file in this directory after a successful conversion.\r\n\r\nThis folder name and location be changed in the System Settings page.	folder \'mcebuddyarchive\ pong chenmoH nuqDaq teywI' original orginal teywI' qaStaHvIS directory vIH located\r\nand qaSpu'DI' choH 'ej location successful conversion.\r\n\r\nthis folder pong qaStaHvIS pat Settings page.
Debug - detailed logs, helps trace conversion problems\r\nInformation - logs basic information about conversion\r\nWarning - log potential issues or critical failures only\r\nError - log critical failures only	wanI'vammo' trace conversion problems\r\ninformation-QonoS basic De' conversion\r\nwarning vIHtaHbogh-QonoS potential tlha' pagh only\r\nerror critical failures-QonoS critical failures neH QaH debug-detail QonoS,
Select the conversion profile associated with this task. The conversion profile represents the output format and quality for the converted file.\r\nHigher quality conversions take longer to convert. Reccomended Default: MP4 High Quality or MP4 Normal.\r\n\r\nTIP: Refer to the MCEBuddy Guide for advanced parameters to tweak conversion profiles or to create your own conversion profiles	conversion qoghDu'DajDaq Qu' maqochpu'na' maHtaH wIv. output format 'ej Dojqu'mo' vupmoHmo' bIDameH mIw file.\r\nhigher laHlIj conversions ghaH bIDameH nI'qu' laHlIj 'oS SuvwI' conversion qoghDu'DajDaq. reccomended Default: mp4 jen laHlIj pagh mp4 normal.\r\n\r\ntip: Refer mcebuddy DevwI' 'Itlh parameters conversion qoghDu'DajDaq tweak pagh conversion qoghDu'DajDaq chenmoH
Select the program MCEBuddy will use to strip out any commercials while converting the video.\r\nSet to 'None' to leave the commercials in the converted video.\r\n\r\nTIP: To use ShowAnalyzer instead of Comskip, please download and install ShowAnalyzer.\r\nShow Analyzer version 1.0 and greater supported.	ghun DanoHmeH mcebuddy strip commercials vay' poStaHvIS pagh commercials DaH qaStaHvIS bIDameH video.\r\n\r\ntip video.\r\nset bIDameH wIv: Qutlh showanalyzer lo' instead of comskip, nuqneH download 'ej showanalyzer.\r\nshow Analyzer version 1.0 'ej matay'DI' jom.
Used to change the video quality of the converted file, normal is 1.\r\nA higher number will improve quality but will take more time for conversion.\r\nA smaller number will reduce the quality but speed up the conversion.	DanoHmeH choH video laHlIj vupmoHmo' bIDameH teywI', motlh, laHlIj Dub 1.\r\na veb mI' 'ach latlh poH ghaH laHlIj reduce 'ach Ha' conversion speed conversion.\r\na smaller mI'.
Enter pattern to match filenames for this task (e.g. *.wtv will convert all files ending with .wtv)\r\nPrefix pattern with ~ to skip the match (e.g. *.*;~*.wtv will process all files except those ending with .wtv)\r\nSeparate multiple patterns with ; (e.g. *.wtv;ncis*;~ncis miami*) will process all .wtv files and all files starting with ncis but not those starting with ncis miami\r\n\r\nYou can use regular expressions to match the pattern by starting with regex:	pattern Qu' filenames qul naQmey 'el (e.g. Hoch teywI', .wtv)\r\nprefix pattern je qabna'Daj bIDameH *.wtv ~ skip qul naQmey (e.g. *. *; Hoch teywI' jIQongqa'laHbe' nuv multiple patterns je qabna'Daj .wtv)\r\nseparate; 'angmeH mIw ~*.wtv (e.g. *.wtv; ncis *; ~ ncis miami *) teywI' .wtv Hoch Hoch teywI', ncis starting 'ej mIw 'ach regular mIS je 'ang qabDaj laH wej nuv starting ncis miami\r\n\r\nyou qul naQmey pattern pong starting regex:
Enter pattern to match show/series titles for this task (e.g. Simpson* will convert all files that have a show title starting with Simpson)\r\nPrefix pattern with ~ to skip the match (e.g. *;~Simpson* will process all show titles except those that start with Simpson)\r\nSeparate multiple patterns with ; (e.g. Simpson*;House*) or (e.g. Simpson*;NCIS*;~NCIS Miami*)\r\n\r\nYou can use regular expressions to match the pattern by starting with regex:	pattern cha' ghap series titles Qu' (Hoch teywI' Daghajbogh cha' title simpson starting bIDameH e.g. simpson *) qul naQmey 'el \r\nprefix pattern ~ skip qul naQmey (e.g. *; ~ Hoch cha' titles jIQongqa'laHbe' 'e' simpson start nuv mIw simpson *) \r\nseparate patterns multiple, je; (e.g. simpson *;house*) pagh (e.g. simpson *;ncis*; ~ ncis miami *) regular mIS je 'ang qabDaj laH DanoHmeH \r\n\r\nyou qul naQmey pattern pong starting regex:
This can be used to override the default Audio Language when there are multiple audio languages in a recording.\r\nTo get the list of the Audio Languages in a recording, right click on the file in the queue and select MediaInfo.\r\n\r\n<Default> will try to keep all audio tracks if supported or let the encoder choose the default audio track\r\n<Original>, if available, will use the original [non-dubbed] recording language	nuq DanoHmeH default 'e' Hoch ghoch audio pol vaj Qutlh pagh encoder default audio track\r\n <Original>wutlh yInISQo' nID Audio Hol HeghDI' lugh click queue teywI' je wIv mediainfo.\r\n\r\n <Default>, multiple audio Hol recording.\r\nto Suq Audio Hol recording, qaStaHvIS tetlh ngep, vaj lupoQ, original [QI'yaH-dubbed] recording Hol yIlo'
Enter '[video]' or leave blank to convert all video files\r\nEnter pattern to match filenames for this location (e.g. *.wtv will convert all files ending with .wtv)\r\nPrefix pattern with ~ to skip the match (e.g. *.*;~*.wtv will process all files except those ending with .wtv)\r\nSeparate multiple patterns with ; (e.g. *.wtv;ncis*;~ncis miami*) will process all .wtv files and all files starting with ncis but not those starting with ncis miami	"[video]" 'el pagh mej blank Hoch video files\r\nenter pattern filenames location qul naQmey bIDameH (e.g. Hoch teywI', .wtv)\r\nprefix pattern je qabna'Daj bIDameH *.wtv ~ qul naQmey skip (e.g. *. *; Hoch teywI' jIQongqa'laHbe' nuv multiple patterns je qabna'Daj .wtv)\r\nseparate; 'angmeH mIw ~*.wtv (e.g. *.wtv; ncis *; ~ ncis miami *) teywI' .wtv Hoch 'ej Hoch teywI', ncis wej nuv starting ncis miami je 'ach starting mIw
MCEBuddy Settings	mcebuddy Settings
MCEBuddy does NOT use the currently logged in user to connect to network shares, it uses its own service account.  Be sure to specify the connection user information [MCEBuddy with a key icon]	currently QonoS user wej DanoHmeH mcebuddy rar network SoH, account chavmoH lumaq lach'eghDI' ngat.  connection user De' [mcebuddy icon ngaQHa'moHwI'mey] per be
Please supply a source name	nuqneH, Hal pong supply.
Please supply a search path name	nuqneH search path pong supply
A source name or section	Hal pong 'ay' pagh
already exists. Please use another name	chonayta' nIv'e'. DubelmoHchugh latlh pong yIlo'
Monitor name	jIH pong
Give this a location a unique name	pong unique location nob
Monitor path	jIH path
Select the directory that MCEBuddy will monitor in the background for new video files to convert automatically	directory, qatlh jIH mcebuddy 'e' wIv patmey lulo'ta' chu' video teywI' bIDameH mIw automatically
Click to select the folder to monitor	click folder jIH wIv
Search pattern	search pattern
SourceForm	sourceform
Monitor Location	jIH Location
Normal	motlh
MCEBuddy GUI: pipeProxy engine connection error	mcebuddy gui: pipeproxy QuQ connection Qagh
MCEBuddy GUI: Unable to create pipe to MCEBuddy service	mcebuddy gui: Unable pipe mcebuddy chavmoH chenmoH
The MCEBuddy service is unavailable. Please start from Windows control panel or check engine connection.	mcebuddy chavmoH unavailable. DubelmoHchugh vo' windows SeHlaw start pagh QuQ connection check.
Announcement	announcement
New version 	version chu' 
available	lupoQ
New BETA version 	version BETA chu' 
Click here to download new version of MCEBuddy	click naDev chu' version mcebuddy download
Click here to open link	click naDev link poS
Idle	pagh vIbuSlaw' 'e' vI'angnIS
Closing	SoQ
MCEBuddy GUI: Unable to update tasks	mcebuddy gui: Unable Qu' update
MCEBuddy GUI: Unable to start MCEBuddy service	mcebuddy gui: Unable mcebuddy chavmoH start
MCEBuddy GUI: Unable to stop MCEBuddy service	mcebuddy gui: Unable mcebuddy chavmoH mev
MCEBuddy GUI: Unable to cancel job	mcebuddy gui: Unable job qIl
Warning: Networked files will be accessed using the logon credentials of the MCEBuddy Service, not the currently logged on user. You can manually specify the network credentials from the Settings -> Expert Settings page in MCEBuddy.	warning: naw' teywI' network logon credentials mcebuddy chavmoH wej currently QonoS user lo'. network credentials vo'-> po' Settings page Settings laH manually per mcebuddy.
Credential Warning	credential Warning
Status	Dotlh
MCEBuddy GUI: Unable to add job	mcebuddy gui: Unable job chel
MCEBuddy GUI: Unable to get pipe active status	mcebuddy gui: Unable pipe pov Dotlh Suq
The conversions must be stopped to change settings. Stop the conversions?	ghob'e' mev conversions settings choH. conversions mev?
Stop Engine	QuQ mev
MCEBuddy GUI: Unable to stop MCEBuddy service from settings click	mcebuddy gui: Unable mcebuddy chavmoH vo' settings click 'e' mev
MCEBuddy GUI: Unable to rescan files	mcebuddy gui: Unable rescan teywI'
MCEBuddy GUI: Unable to open link	mcebuddy gui: Unable link poS
Close	SoQmoH
Close this window, MCEBuddy will keep running in the background	SoQ Qorwagh, pol qet mcebuddy patmey lulo'ta'
If you like MCEBuddy, please click here to Donate - THANKS	vaj mcebuddy ghaytan, nuqneH click naDev donate-ghIlDeSten
Click here to like MCEBuddy on facebook	click naDev mcebuddy ghaytan facebook
Click here to open MCEBuddy website	click naDev mcebuddy website poS
Rescan	rescan
Forces the MCEBuddy to recheck the Monitor locations for new video files to convert	mcebuddy recheck jIH locations chu' video teywI' bIDameH raD
Monitor locations	jIH locations
Settings	setting
Select the file(s) in the queue to delete	teywI' wIv queue delete
Manually add video file(s) to the queue to convert	manually video teywI' chel bIDameH mIw queue
Start the MCEBuddy monitor and conversion tasks	mcebuddy jIH conversion 'ej Qu' start
Stop the MCEBuddy monitor and conversion tasks	mcebuddy jIH conversion 'ej Qu' mev
There is a new version!	version chu' tu'lu'!
High	jen
Low	'eS
Priority	priority
High priority - convert faster but may make other running applications unresponsive\r\nLow priority - convert in the background but reduced interference with other running applications	tlhIngan bIDameH 'ach chaq unresponsive\r\nlow priority chenmoH latlh qet applications-bIDameH patmey lulo'ta' reduce interference je latlh qet applications 'ach jen priority-
A task is a conversion template that contains a conversion profile and various other conversion parameters.\r\nEach file added to the queue will be processed and converted by each of these tasks.\r\nRefer to the MCEBuddy Guide for more details on how tasks work.	Qu' conversion template 'e' conversion qoghDu'DajDaq Sar latlh conversion parameters.\r\neach 'ej Sev mIw 'ej pong mcebuddy DevwI' latlh details chay' Qap Qu' tasks.\r\nrefer Hoch bIDameH teywI' chel queue.
Getting started	wej started
Click here for MCEBuddy guide	click naDev mcebuddy Dev
Logs	QonoS
Click to open log folder	click QonoS folder poS
MCEBuddy Status	mcebuddy Dotlh
add	boq
delete	delete
paypal-donate	paypal-donate
stop	mevyap
OUTPUT: ConsoleOuput received NULL data	OUTPUT: NULL De' Hev consoleouput
hours	rep
minutes	tup
second	cha'DIch
seconds	cha'DIch
Starting	start
Comskip advertisement scan - Pass 1	comskip qeS Hoch HoS puS Hotlh-juS 1
Comskip advertisement scan - Pass 2	comskip qeS Hoch HoS puS Hotlh-juS 2
Cutting commercials from video	pe'meH commercials vo' video
Cutting commercials from video - segment 	segment pe'meH commercials video-vo' 
Merging commercial free segments into new video	commercial segments tlhab merging vaj video chu'
Moving converted file to destination	teywI' bIDameH vIH ghoch
Checking for disk space	checking gho Doqqu' logh
Getting show information and banner from Internet sources	cha' De' banner 'ej wej internet Hal vo'
Copying source file to working directory	Hal teywI' copying working directory
Remuxing recording	remuxing recording
ShowAnalyzer advertisement scan	showanalyzer qeS Hoch HoS puS Hotlh
Comskip advertisement scan	comskip qeS Hoch HoS puS Hotlh
Analyzing video information	video De' poj
Converting	vupmoHmo' bIDameH
Removing commercials	commercials teq
Writing show information	De' cha' ghItlh
Renaming file using show information	rename teywI' cha' De' yIlo'
Success - All done!	Qapla'-Hoch Qu'!
Muxing streams	muxing streams
Fallback remux	fallback remux
Correcting audio delay	audio mIm lugh
Converting video file - Pass 1	video teywI'-juS 1 bIDameH
Converting video file - Pass 2	video teywI'-juS 2 bIDameH
Converting video file	video teywI' bIDameH
Audio Track	ghoch audio
Impaired	QIHlu'
Channels	channel
Codec	codec
Video	video
Duration	duration
Height	'ab
Width	width
Audio	audio
Name	pong
Subtitle	subtitle
Volume	muq
Enable custom file renaming	teywI' tIgh renaming enable
Enable this to enter a custom pattern to rename converted files and folders. Enter the custom pattern in the box below.\r\n\r\nExample:\r\nTVShows\%showname%\Season %season%\%showname% - S%season%##E%episode%## - %episodename% - %airyear%_%airmonth%_%airday%\r\n\r\nWill produce:\r\nTVShows\CSI\Season 1\CSI - S01E02 - Best of times - 2012_01_06.<ext>\r\n\r\nExample:\r\nRecording\%ismovie%<Movie\%showname%,TVShows\%showname%\Season %season%\%showname% - S%season%##E%episode%##>-Converted\r\n\r\nWill produce (for a movie)\r\n    Recording\Movies\Star Wars-Converted.<ext>\r\nOR (for non movies)\r\n    Recording\TVShows\CSI\Season 1\CSI - S01E02-Converted.<ext>\r\n\r\nRefer to the MCEBuddy advanced documentation for a list of all the pattern commands.	pIqar 'el tIgh pattern, bIDameH teywI' folders 'ej rename enable. pattern tIgh 'el box below.\r\n\r\nexample:\r\ntvshows\%showname%\season %season%\%showname%-s vatlhvI' maqtagh vatlhvI' #e vatlhvI' episode vatlhvI' ##-vatlhvI' episodename vatlhvI'-%airyear%_%airmonth%_%airday%\r\n\r\nwill lIng: \r\ntvshows\csi\season_1\csi-s01e02--2012_01_06 poH nIvbogh.<ext>\r\n\r\nexample:\r\nrecording\%ismovie% < movie\%showname%,tvshows\%showname%\season %season%\%showname%-s%season%##e%episode%##>-converted\r\n\r\nwill lIng (movie) \r\n_recording\movies\star veS-bIDameH. <ext>\r\nor (QI'yaH movies) \r\n_recording\tvshows\csi\season 1\csi-s01e02-bIDameH mIw.documentation tetlh Hoch pattern ra' 'Itlh <ext>\r\n\r\nrefer mcebuddy.
ShowAnalyzer not found.\nPlease download and install ShowAnalyzer.	wej tu' showanalyzer. download \nplease 'ej showanalyzer jom.
ShowAnalyzer Missing	showanalyzer Missing
Invalid language code, reverting to <Default> language	Hol invalid ngoq, luSpetDaq <Default>Hol
Cut start	start pe'
Cut end	van pe'
This specifies the number of seconds to cut from the start of the recording (BEFORE removing the ads)	mI' cha'DIch pe' vo' (pa' teq) ads recording start per
This specifies the number of seconds to cut from the end of the recording (BEFORE removing the ads)	mI' cha'DIch pe' vo' (pa' ads teq) recording 'er'In per
Send an eMail after each conversion.	[jIboQqang qaSpu'DI' Hoch conversion. ghaHDaq ngeH BERNARDO.
Send eMail	eMail ngeH
SMTP Server Name	smtp jabwI' pong
Enter the outgoing eMail (SMTP) server address here\r\ne.g. smtp.gmail.com	outgo (smtp) eMail jabwI' SoQ here\r\ne.g 'el. smtp.gmail.com
Port	rut mutlha'taH
Enter the SMTP server port	rut smtp jabwI' mutlha'taH 'el
Use SSL	malja' ssl
Check this if you SMTP server uses SSL	ghu'vam check vaj ssl lo' jabwI' smtp
e-Mail Settings	e-Mail Settings
From <e-Mail>	vo' <e-Mail>
Enter the senders (From) eMail address here	senders 'el (vo') eMail SoQ naDev
To <e-Mails>	<e-Mails>
Enter the recipients (To) eMail address here.\r\nSeparate multiple recipients with a semicolon (;)	() multiple SIQwI' (;) semicolon eMail SoQ here.\r\nseparate SIQwI' 'el
Send eMail on successful conversion	eMail ngeH successful conversion
Send eMail on failed conversion	eMail ngeH luj conversion
Send eMail on cancelled conversion	eMail ngeH qIl conversion
Send eMail on adding a conversion to the queue	eMail conversion queue chel ngeH
Please enter a valid server address	nuqneH, valid jabwI' SoQ 'el.
Invalid SMTP Server	jabwI' smtp invalid
Please enter a valid server port	nuqneH, valid jabwI' rut mutlha'taH 'el.
Invalid SMTP Port	invalid smtp rut mutlha'taH
Please enter a valid From eMail address	nuqneH valid 'el vo' eMail SoQ
Invalid eMail Address	invalid eMail SoQ
Please enter valid To eMail addresses	DubelmoHchugh 'el SoQ eMail valid
Username	username
<Optional> Enter the username for the eMail server authentication	<optional>'el eMail jabwI' authentication username
<Optional> Enter the password for the eMail server authentication	<optional>'el eMail jabwI' authentication mu'wIj
MCEBuddy unable to download series information	mcebuddy unable series De' download
MCEBuddy successfully converted a video	successfully video bIDameH mcebuddy
Source Video	Hal Video
Converted Video	vupmoHmo' bIDameH Video
Converted At	qaStaHvIS bIDameH
MCEBuddy failed to converted a video	video vupmoHmo' bIDameH luj mcebuddy
Failed At	luj nuqjatlh
MCEBuddy cancelled a video conversion	video conversion qIl mcebuddy
Cancelled At	qaStaHvIS qIl
Working	Qap
Test	waH
Testing	waH
Click this button to test the eMail server settings	button eMail jabwI' settings waH click
MCEBuddy will send an eMail to test the server settings.\r\nThis can take upto 60 seconds.\r\nMCEBuddy may be unresponsive during this period.	jIboQqang jabwI' settings.\r\nthis waH ngeH mcebuddy laH ghaH upto 60 seconds.\r\nmcebuddy chaq unresponsive during puj.
Test eMail	waH eMail
MCEBuddy Test eMail	mcebuddy waH eMail
MCEBuddy - Have a great day!	mcebuddy-ghaj jaj Dun!
Send eMail test successful	eMail waH ngeH successful
Send eMail test failed! Please check your settings and internet connectivity	eMail waH luj ngeH! nuqneH 'ej internet connectivity settings check
Test eMail Success	Qapla' eMail waH
Test eMail Failed	eMail failed waH
Send eMail on start of conversion	eMail ngeH start conversion
MCEBuddy started a video conversion	video conversion started mcebuddy
Conversion Started At	qaStaHvIS Started conversion
Yes (Comskip)	HIja' (comskip)
Yes (ShowAnalyzer)	HIja' (showanalyzer)
Atleast one Conversion Task must be enabled	atleast ghob'e' enabled Qu' Conversion wa'
Disable	Qotlh
Enable	enable
Rename	rename
Move	vIH
Up	Ha'
Down	vI'ogh
Slow Remuxing	remuxing slow
Extracting closed captions	SoQ captions extracting
Validating closed captions	SoQ captions validating
Extracting subtitles	subtitles extracting
Trimming closed captions	SoQ trimming captions
Extract subtitles and closed captions	extract subtitles 'ej captions SoQ
Field	yotlh
Channel	channel
Enable this to extract Closed Captions, Subtitles and Teletext from\r\nWTV, DVR-MS, TS, MP4, MKV and other supported files.\r\n\r\nIt is saved as a Subtitle (SRT) file.	pIqar SoQ Captions extract enable, yemwI' Subtitles Teletext from\r\nwtv, dvr-ms, rut, mp4, mkv 'ej latlh Qutlh files.\r\n\r\nit law' Subtitle ((srt)) teywI'.
Enable this to set advanced options for Closed Captions extraction\r\nField - 1 or 2\r\nChannel - 1 or 2\r\n\r\nDefault: Field 1, Channel 1	'Itlh DuH SoQ Captions extraction\r\nfield-2\r\nchannel-QInvam 1 pagh 2\r\n\r\ndefault, pagh 1 HIjmeH enable: 1 yotlh Channel 1,
Subtitle offset	subtitle offset
Enter the number of seconds (+ve / -ve) to adjust the subtitles sync with video	mI' cha'DIch 'el (+ ve ghap-ve) lIS subtitles sync video
Re-ReMuxing due to audio error	re-remuxing yo'a'neS Hajmo' muHIvtaHbogh audio Qagh
Save the poster and show information (metadata) in a MC/XBMC compatible NFO file (XML format)	poster pol 'ej De' (metadata) cha' qaStaHvIS mc ghap xbmc compatible nfo teywI' (xml format)
Check this box to save the show information (metadata) in the converted file.\r\nThis only works for files that support metadata tags like MP4, MKV, WTV etc.\r\n\r\nNOTE: Uncheck this box if you're facing issues with some devices such as older TV's which have problem reading metadata.	box cha' De' (metadata) pol qaStaHvIS bIDameH file.\r\nthis neH mp4, mkv, ghaytan, baj teywI' 'ej QuQ metadata maq per Qutlh 'e' check wtv etc.\r\n\r\nnote: box Uncheck vaj wanI'vammo' tlha' qab SoH je such as older tv qay' reading metadata jechlaHbe'bogh jan 'op.
Atleast one day of the week must be enabled	wa' jaj Hogh ghob'e' enabled atleast
Invalid Days of Week	Hogh jaj invalid
Invalid day of week found in configuration file	Hogh vItu' configuration teywI' jaj invalid
Scheduling	schedule
Remuxing to	remuxing
Part	lopno'
Rest your mouse on any button, box or item to get Instant Help on it.\n\nFor more information on how to use, troubleshoot or get support for MCEBuddy click on the <Getting Started> link on the top right corner.\n\nDonations are always welcome :) Enjoy!\n\n  - Ramit, Derek & Goose	Hoch < Suq Started > link yor lugh corner.\n\ndonations click mouse vay' button, box pagh item latlh De' chay' yIlo', troubleshoot pagh mcebuddy Qutlh Suq Suq Instant QaH it.\n\nfor reH majQa' :) tIv! \n\n-ramit, derek je 'etlh vaQ puS
Welcome to MCEBuddy	majQa' mcebuddy
Multichannel audio	multichannel audio
Check to allow multi-channel audio if the source video supports it.\r\nBy default the audio is limited to 2 channels (stereo).	vuS 2 channels (stereo) check multi-channel audio chaw' vaj it.\r\nby default audio Qutlh Hal video.
Dynamic Range Compression (DRC)\r\nWhen the source is an AC3 audio, enabling DRC will\r\nreduce the difference between the loud and the soft\r\nsounds making the audio track more even.\r\nIf you have a multi-channel audio recording and you\r\nfeel the volume is too soft, checking this box might help.	dynamic Range Compression (drc) \r\nwhen Hal ac3 audio, drc will\r\nreduce DuqIppu'chugh HoS jachpu'DI' soft\r\nsounds neH even.\r\nif multi-channel audio recording you\r\nfeel muq tun je, je checking chaq, qatlh QaH box chenmoH ghoch audio difference enabling.
FPS	FPS
Logfile age (days)	qantaHvIS logfile (days)
Maximum number of days to keep the logfiles before deleting them.\r\nSet to 0 to keep the logs forever.	jaj logfiles pol pa' them.\r\nset 0 QonoS pol reH deleting 'aqroS mI'.
DVRMS Remuxing	dvrms remuxing
Fast Remuxing	nom remuxing
Byte stream remuxing	byte stream remuxing
Disable cropping	cropping Qotlh
Check this to disable cropping the video automatically during conversion.\r\nCropping is used to remove the "black bars" in the video (top, bottom, left or right).\r\nUse this option if the video picture is getting cut on any side or if the final picture is looking stretched or distorted.	"qIj tach" teq yIlo' Qotlh video cropping automatically during conversion.\r\ncropping check video (yor, pIrmuS, poS pagh right).\r\nuse vaj Suq pe' mIllogh video vay' Dop pagh legh mIllogh Qav wochbogh pagh distorted DuH.
Only detect Ads	neH, Ads detect.
Check this if you want MCEBuddy to detect the ads (commercials) but NOT cut them from the video.\r\nWhen this option is enabled, MCEBuddy will create an EDL file along with the converted file that specifies the locations of ads in the converted video.\r\nAlso, for MP4, M4V and MKV files MCEBuddy will create Chapters to mark the end of commercials.	check mcebuddy (commercials) ads detect vIneH 'ach wej chaH tugh pe' 'e' vo' video.\r\nwhen enabled DuH, edl teywI' vupmoHmo' bIDameH teywI' 'e' locations ads per vupmoHmo' bIDameH mIw video.\r\nalso, mp4, m4v along with chenmoH mcebuddy 'ej Chapters commercials van ghItlh chenmoH mkv teywI' mcebuddy.
Download information	De' download
Correction	correction
Click here to correct the Show title and force use of a specific TVDB series id or IMDB movie id\r\nto lookup additional metadata from the internet.	click naDev cha' title lugh 'ej specific tvdb series id imdb movie id\r\nto lookup Saturjaj metadata joq malja' raD vo' internet.
Check this to download additional information from the internet about the show like a banner file, episode, season etc	ghItlhvam Saturjaj De' download vo' umqu' ghot rur banner teywI', episode, maqtagh etc cha' internet check
Profile Error	qoghDu'DajDaq Qagh
Cannot find selected profile in profiles.conf	pagh wIv qoghDu'DajDaq tu' profiles.conf
Invalid Profile	invalid qoghDu'DajDaq
Please select a valid profile	nuqneH, qoghDu'DajDaq valid wIv.
The MCEBuddy Engine has crashed. Please send mcebuddy.log to the developers	crashed mcebuddy QuQ. DubelmoHchugh mcebuddy.log ngeH developers
Comskip INI	comskip ini
Select the custom Comskip INI file to use for this conversion task\r\nLeave this blank to use the default Comskip INI file for advertisement removal	wIv tIgh comskip ini teywI' blank DanoHmeH conversion task\r\nleave comskip ini teywI' default lo' qeS Hoch HoS puS removal
Click to select custom Comskip INI file	click teywI' comskip ini tIgh wIv
Select the folder for working with temporary files. Make sure there is enough empty space on the drive.\r\nLeave this blank to use the default temp folder in the installation folder.	folder ru' teywI' Qap wIv. chenmoH be tu'lu' default temp folder yIlo' installation folder blank logh drive.\r\nleave yap chIm.
Select the folder for working with temporary files. Make sure there is enough empty space on the drive.\r\nThis overrides the temp folder specified in the Settings -> Expert Settings page.	folder ru' teywI' Qap wIv. chenmoH be tu'lu' temp folder qaStaHvIS-> po' Settings page Settings per ngep yap chIm logh drive.\r\nthis.
Click to select temp working folder	click temp working folder wIv
Temp folder	temp folder
Space check	logh check
When enabled MCEBuddy will check for enough free space for the conversion (destination and temp).\r\nUncheck this if you have are having trouble with network drives or have extraordinarily large video files.	ghorgh check enable mcebuddy yap tlhab logh conversion (ghoch 'ej temp).\r\nuncheck chorDaq ghotvam'e' luleghmo' yItungHa', qaH QaQ network pagh chaq extraordinarily yIteb teywI' video.
MCEBuddy Windows Event Logs	mcebuddy windows wanI' logs
Events	wanI'
Click here to open the MCEBuddy Windows Event Logs	click naDev mcebuddy windows wanI' logs poS
Enable UPnP	upnp enable
Check this to enable UPnP. This allows access to MCEBuddy engine from outside the network.\r\nThis needs to be checked if you're using a mobile/standalone MCEBuddy client to access MCEBuddy.	ghItlhvam enable upnp check. vaj mobile ghap standalone mcebuddy client DanoHmeH naw' mcebuddy checked nIS naw' mcebuddy QuQ vo' Hur network.\r\nthis chaw'.
Click here to connect to another MCEBuddy engine	click naDev rar QuQ mcebuddy latlh
MCEBuddy Remote Engine Connection	mcebuddy Hop QuQ Connection
Engine Name	QuQ pong
Engine Port	QuQ rut mutlha'taH
Enter the Name or IP Address of the MCEBuddy engine you want to connect to	pong ip SoQ mcebuddy QuQ rar DaneH'a' pagh 'el
Enter the TCP Port number of the MCEBuddy Engine you want to connect to	tcp rut mutlha'taH So'meH mcebuddy QuQ rar DaneH'a' 'el
Enter the TCP Port number of the MCEBuddy Engine you want to connect to (1 to 63355)	tcp rut mutlha'taH So'meH mcebuddy QuQ rar (1 63355) DaneH'a' 'el
Invalid Name/Port	rut invalid pong ghap mutlha'taH
Please enter a valid Engine Name and Engine Port Number	nuqneH valid QuQ pong QuQ rut mutlha'taH mI' je
Error Stopping Engine	Qagh Stopping QuQ
Unable to stop MCEBuddy engine, settings may not be saved. Do you want to continue?	unable mcebuddy QuQ mev, chaq wej yemwI' settings. taH DaneH?
Unable to communicate with engine. Settings have NOT been saved.	unable jatlhmeH QuQ. wej yemwI' settings.
Communication Error	QumpIn Qagh
Engine not stopped. Settings have NOT been saved.	QuQ not mev. wej yemwI' settings.
Unable To Save Settings	unable Settings toD
Unable to communicate with engine. UPnP settings have not been updated	unable jatlhmeH QuQ. wej updated upnp settings
Audio delay	audio mIm
Enter a value in seconds (positive or negative) here to shift the audio relative to the video.\r\nUse this to resync the audio with the video, if they are out of sync after conversion.\r\nA positive value will delay the audio (i.e. video ahead of audio) and a negative value will advanced the audio (i.e. audio ahead of video).\r\nE.g. -1.5	cha'DIch (be pagh negative) lo'laHghach 'el naDev video, audio resync tlhoy sync qaSpu'DI' conversion.\r\na shift relative to video.\r\nuse audio audio (i.e. video ahead of audio) mIm be lo'laHghach 'ej audio (i.e. audio ahead of video).\r\ne.g. 'Itlh, qatlh vaj negative lo'laHghach -1.5
Media info	media info
Click here to get media properties for selected files	click naDev media bang wej wIv teywI'
Save information	De' toD
Add information	De' chel
Shows a preview of the custom filename and path	tIgh filename path 'ej preview cha'
Invalid Filename Pattern	invalid filename Pattern
TVDB Series ID	tvdb Series id
IMDB Series ID	imdb Series id
Original title	original title
Corrected title	lugh title
Enter the TVDB Series ID you want to use for downloading show information.\r\nIf the Original title box is empty, this will be applied to all shows selected by this conversion task.	tvdb Series id cha' downloading lo' DaneH'a' 'el information.\r\nif Original title box chIm, applied Hoch cha', wIv conversion Qu'.
Enter the IMDB Movie ID you want to use for downloading movie information.\r\nIf the Original title box is empty, this will be applied to all shows selected by this conversion task.	imdb Movie id movie information.\r\nif Original downloading lo' DaneH'a' 'el title box chIm, applied Hoch cha', wIv conversion Qu'.
Internet Lookup Title and Metadata Correction	internet Lookup Title 'ej metadata Correction
Click here to add another row to match and correct titles and series id.\r\nIf you want to use the same corrected title or series id for all shows converted by this conversion task,\r\nleave the original title blank on the first row and you should NOT add a second row.	click naDev latlh row qul naQmey 'ej titles 'ej series id.\r\nif rap lugh title series id Hoch cha', bIDameH conversion Qu', pagh lo' DaneH'a' lugh chel \r\nleave original title blank wa'DIch cha'DIch row vaj wej chel row 'ej.
Enter pattern to match show/series titles for correction (e.g. Simpson* will replace all titles that have a show title starting with Simpson)\r\nPrefix pattern with ~ to skip the match (e.g. *.*;~Simpson* will correct all show titles except those that start with Simpson)\r\nSeparate multiple patterns with ; (e.g. Simpson*;House*) or (e.g. Simpson*;NCIS*;~NCIS Miami*)\r\n\r\nNOTE: Leave this box empty if you want to apply the corrected title or series id to ALL files being processed by this conversion task.\r\nIf leaving blank, you cannot add a second row.\r\n\r\nYou can use a regular expression to match the title by starting with regex:	pattern cha' ghap series titles correction ngaSwI' yuvtlhe' (Hoch titles Daghajbogh cha' title simpson starting wIngaQmoHta'DI' e.g. simpson *) qul naQmey 'el \r\nprefix pattern ~ skip qul naQmey (e.g. *. *; ~ lugh, simpson * jIQongqa'laHbe' 'e' simpson start nuv titles cha' Hoch) \r\nseparate patterns multiple, je; (e.g. simpson *;house*) pagh (e.g. simpson *;ncis*; ~ ncis miami *) \r\n\r\nnote: box mej chIm lugh title pagh series id apply Hoch teywI', mIw pong conversion task.\r\nif DaH blank DaneH'a', vaj regular mIS je 'ang qabDaj laH DanoHmeH cha'DIch row.\r\n\r\nyou qul naQmey title pong starting regex pagh chel SoH:
Enter the new/corrected title you want to use for downloading additional information from the internet.\r\nIf the Original title box is empty, this will be applied to all shows selected by this conversion task.\r\n\r\nYou can use a regular expression to correct the title by starting with regex:	chu' ghap lugh title lo' Saturjaj De' downloading DaneH'a' 'el vo' Original internet.\r\nif title box chIm, applied Hoch cha' wIv conversion regular mIS je 'ang qabDaj laH DanoHmeH task.\r\n\r\nyou pong starting regex lugh title:
For each row, please enter the Original title to match the show name AND either a Corrected title or a TVDB/IMDB Series ID	Hoch row, nuqneH Original title qul cha' pong vIDablaH. jIwivlaH corrected 'ej naQmey 'el title tvdb ghap imdb Series id pagh
Please enter either a Corrected title or a TVDB/IMDB Series ID	DubelmoHchugh corrected title, pagh tvdb ghap imdb Series id 'el
Enable this if you want MCEBuddy to put the converted file in the source directory\r\nif the destination path is unavailable. (e.g. Network failure or mapping failure)	ghu'vam enable vaj mcebuddy bIDameH lan neH Hal directory\r\nif ghoch path teywI' unavailable. (e.g. failure mapping failure pagh Network)
Fallback to source path	fallback Hal path
Used to increase or decrease the volume of the\r\nrecording while converting.\r\n1 is normal, anything below will reduce it, anything\r\nhigher will increase it.	ghur pagh the\r\nrecording muq nup poStaHvIS converting.\r\n1 motlh yIlo', reduce je below vay', 'oH, chu'wI' ghur anything\r\nhigher.
Archive folder	archive folder
Change the location of the archive folder.\r\nLeave empty to use the default 'MCEBuddyArchive' folder in the original directory.	location archive folder.\r\nleave chIm default ' mcebuddyarchive ' folder original directory lo' choH.
Monitor subdirectories	jIH subdirectories
Check this box to also monitor all directories within the Monitor path	box je Hoch directories qaS jIH path jIH check
Click here to show MCEBuddy status	click naDev mcebuddy Dotlh cha'
MCEBuddy service not connected	mcebuddy chavmoH rar wej
MCEBuddy idle	mcebuddy pagh vIbuSlaw' 'e' vI'angnIS
conversions in progress	conversions lI'
MCEBuddy stopped	mev mcebuddy
Sync converted files	sync bIDameH teywI'
Check this option if you want MCEBuddy to keep the converted files in sync with the original files.\r\ni.e. When the original files are deleted by the user, the corresponding converted files are also deleted.\r\n\r\nNOTE: MCEBuddy only monitors original files in the monitor locations folders and ONLY while the engine is running.\r\nMCEBuddy will not be able to track user deleted files while the engine is stopped.	DuH check vaj mcebuddy bIDameH teywI' pol je sync je original files.\r\ni.e neH. HeghDI' deleted teywI' original pong user, correspond bIDameH teywI' je deleted.\r\n\r\nnote: neH original teywI' jIH locations folders jIH mcebuddy 'ej neH poStaHvIS QuQ running.\r\nmcebuddy wej vay' user deleted teywI' ghoch poStaHvIS mev QuQ.
Do you wish MCEBuddy to delete each converted file when the original file has been deleted?	mcebuddy Hoch bIDameH teywI' delete HeghDI' deleted teywI' original DaneHchugh?
Confirm sync conversions?	sync conversions confirm?
Are you sure you DO NOT want to remove commercials from the converted video and only keep the EDL file?	SoH be commercials teq vo' bIDameH video 'ej neH edl teywI' DaneH'a' Qu' qar'a'?
ShowAnalyzer is not responding. Please the reboot system or reinstall ShowAnalyzer.	wej responding showanalyzer. reboot pat bel pagh reinstall showanalyzer.
ShowAnalyzer Not Responding	showanalyzer wej Responding
Make sure you press 'Start' after closing this window, otherwise Scheduling and Wake will not work.	chenmoH be "Start" press Qorwagh SoQ qaSpu'DI', vuDwIj wej Qap scheduling 'ej Wake.
Enabling Scheduling and Wake	enable Scheduling 'eb 'ej So'meH Wake
Passwords do not match	qul wej naQmey mu'wIj
Password error	mu'wIj Qagh
Adding subtitles and chapters to file	chel subtitles 'ej chapters teywI'
Send eMail if unable to download series information	eMail ngeH vaj unable series De' download
Check this box if you want this conversion task to only process files from specific monitor locations.\r\nIf unchecked each conversion task will process files from all monitor locations (including new ones added later).	box check vaj conversion Qu' neH teywI' vo' specific jIH locations.\r\nif unchecked teywI' vo' Hoch jIH locations DaH (chu' wa', later chel nobvam) mIw Qu' conversion Hoch mIw DaneH'a'.
Select Monitor Locations	jIH Locations wIv
Select atleast one Monitor Location name	atleast wa' jIH Location pong wIv
You have selected all the current Monitor Locations.\r\nDo you want this conversion task to automatically process any new Monitor Locations added in future?	Hoch Qu'mey potlh jIH locations.\r\ndo conversion Qu' automatically vay' chu' jIH Locations je pIq chel mIw DaneH'a' DawIvta''a'?
New monitor locations	locations jIH chu'
Invalid selection	invalid selection
Channel name match	channel pong qul naQmey
Enter pattern to match the channel name for this task (e.g. ABC* will convert all files that recorded on a channel name starting with ABC)\r\nPrefix pattern with ~ to skip the match (e.g. *;~ABC* will process all channels except those that start with ABC)\r\nSeparate multiple patterns with ; (e.g. ABC*;TBS*) or (e.g. ABC*;Fox*;~Fox4*)\r\n\r\nYou can use regular expressions to match the pattern by starting with regex:	pattern channel pong Qu' (Hoch teywI' 'e' ta channel pong starting abc bIDameH e.g. abc *) qul naQmey 'el \r\nprefix pattern ~ skip qul naQmey (e.g. *; ~ Hoch channels jIQongqa'laHbe' 'e' abc start nuv mIw abc *) \r\nseparate patterns multiple, je; (e.g. abc *;tbs*) pagh (e.g. abc *;fox*; ~ fox4 *) regular mIS je 'ang qabDaj laH DanoHmeH \r\n\r\nyou qul naQmey pattern pong starting regex:
Clear history	HuvchoH qun
Click this button to clear the history of all converted files.\r\nThis is cause MCEBuddy to reconvert all files being monitored.	mcebuddy Hoch teywI', jIH reconvert luH click Hoch bIDameH files.\r\nthis qun Huv button.
Are you sure you want to clear the history of all conversions?\r\nThis will cause MCEBuddy to reconvert all files being monitored.	SoH be Hoch conversions qun Huv DaneH'a'? mcebuddy Hoch teywI', jIH reconvert luH \r\nthis.
Show history	cha' qun
Click this button to show the history of all converted files.	button Hoch bIDameH teywI' qun cha' click.
History of Converted Files	teywI' bIDameH qun
Unable to communicate with engine.	unable jatlhmeH QuQ.
Extracting streams	streams extracting
Fallback muxing streams	fallback muxing streams
Remuxing TiVO file	remuxing tivo teywI'
Enter your 10 digit TiVO MAK key to convert and process TiVO recordings	10 digit tivo mak ngaQHa'moHwI'mey bIDameH 'ej tivo recordings mIw 'el
Invalid TiVO MAK Key	invalid tivo mak ngaQHa'moHwI'mey
The TiVO MAK key should be 10 digits	tivo mak ngaQHa'moHwI'mey vaj 10 digits
Version mismatch. Please ensure that the MCEBuddy client and engine are running the same version.	version mismatch. boghbe'bogh DubelmoHchugh 'e' version rap qet, je QuQ mcebuddy client tangqa'Hom.
Error retrieving Event Logs	Qagh wanI' logs retrieving
Unable to get Event Log Entries from the MCEBuddy engine.	unable wanI' QonoS Entries Suq vo' mcebuddy QuQ.
PAUSED: Check conversion schedule	paused: Check conversion schedule
Logging	QonoS
Folder Management	folder Management
Processor Management	processor Management
Expert Settings	Settings po'
System Settings	pat Settings
Click here to change additional settings (for experts only)	click naDev Saturjaj settings (pIn neH) wIQaw'laH
Failed folder	luj folder
Location of the folder that hold the original files for failed conversions.	conversions luj folder original teywI' 'uch 'e' location.
Move original file on failure	original teywI' failure vIH
Check this to move the original file to a separate folder if the conversion fails.	pIqar teywI' original vIH folder chev vaj luj conversion check.
Check this to limit the number of logical processors that MCEBuddycan use.\r\nEach check box below corresponds to an available logical processor.	ghItlhvam logical processors lupoQ logical processor corresponds mcebuddycan use.\r\neach check box below 'e' mI' vuS check.
Each box represents logical processors from 1 to 16 respectively.\r\nChecking a box allows MCEBuddy to use that processor.	mcebuddy processor lo' chaw' Hoch box 'oS logical processors vo' 1 16 respectively.\r\nchecking box.
Each box represents logical processors from 17 to 32 respectively.\r\nChecking a box allows MCEBuddy to use that processor.	mcebuddy processor lo' chaw' Hoch box 'oS logical processors vo' 17 32 respectively.\r\nchecking box.
Select atleast one processor to use	atleast wa' processor lo' wIv
Invalid Configuration	invalid Configuration
Comskip path	comskip path
If you want to use a custom version of Comkip (e.g. donator version)\r\nthen enter the path of the comskip installation here.\r\nLeave blank to use the default comskip that comes with MCEBuddy.	vaj tIgh version, comkip (e.g. donator version) lo' DaneH'a' wa'DIch comskip installation here.\r\nleave blank default comskip 'e' Ha' mcebuddy lo' path DeghwI' 'el \r\nthen.
Miscellaneous	miscellaneous
Ignore copy protection	copy protection buSHa'
Check this to ignore the copy protection flag on video file while converting.\r\nNOTE: MCEBuddy cannot bypass encryption, this only helps if a file is incorrectly\r\ntagged as copy protected when it is NOT encrypted.	pIqar copy protection joqwI' video teywI' poStaHvIS converting.\r\nnote buSHa' check: encryption pagh bypass mcebuddy, neH QaH tlhoy teywI' incorrectly\r\ntagged je QaD HeghDI' wej encrypted 'oH copy.
Use recycle bin	malja' recycle bin
Check this to use the recycle bin when files are deleted by MCEBuddy	check recycle bin lo' HeghDI' deleted teywI' pong mcebuddy
Poll period	poll puj
This is how often MCEBuddy scans the Monitor Tasks Locations for new files.\r\nThe interval is specified in seconds.	ghotvam'e' chay' pIj jIH Qu' Locations Hotlh mcebuddy per interval files.\r\nthe chu' qaStaHvIS cha'DIch.
Server port	jabwI' rut mutlha'taH
This is the TCP port MCEBuddy uses to communicate with the remote engine.\r\nWhen UPnP is enabled, MCEBuddy will automatically add this port to the Windows Firewall\r\nand UPnP gateway to allow access from the internet on this port.	rut tcp mutlha'taH jatlhmeH rut mutlha'taH automatically chel mcebuddy windows firewall\r\nand upnp gateway naw' chaw' vo' rut mutlha'taH internet Hop engine.\r\nwhen upnp enabled, lo' mcebuddy ghotvam'e'.
Hang period	puj DIr
Enter the number of seconds that MCEBuddy will wait for a response from the\r\nunderlying application before terminates the application as hung.\r\nEnter 0 to disable hang detection.	loD cha'DIch loS mcebuddy response vo' the\r\nunderlying application mI' 'el ngorbogh application je hung.\r\nenter 0 DIr detection Qotlh baq.
Subtitle commercial cut sync	subtitle commercial sync pe'
This parameter is used when the subtitles go progressively out of sync after each commercial segment is removed from the video.\r\nThis setting is used to bring the subtitles back into sync with the video.\r\nEach time the video commercial is cut out, the subtitles are time shifted by this amount (+ve or -ve in seconds).	lo' parameter HeghDI' sync video.\r\neach poH pe' video commercial vaj Dub subtitles DanoHmeH Ha' progressively sync qaSpu'DI' Hoch commercial segment quSmey teqlu'pu' video.\r\nthis setting subtitles qem, subtitles poH shifted pong amount (+ ve-ve cha'DIch).
Invalid poll period	invalid poll puj
Invalid server port	invalid jabwI' rut mutlha'taH
eMail Subject Customization	Subject Customization eMail
Use this section to customize the subject of eMail sent by MCEBuddy on the various conversion events listed below.\r\nRefer to the documentation, custom commands for user defined variables.\r\ne.g. Show %showname% for file %originalfilename% conversion successful using task %taskname%\r\nNOTE: Not always will all the data be available in the custom commands.\r\nLeave blank to use default subject lines.	below.\r\nrefer documentation, tIgh ra' user defined variables.\r\ne.g tetlh malja' ngeH subject eMail customize 'ay' pong mcebuddy Sar conversion wanI'. vatlhvI' showname vatlhvI' teywI' vatlhvI' originalfilename vatlhvI' conversion successful Qu' vatlhvI' taskname%\r\nnote lo' cha': wej reH Hoch De' ghaH lupoQ qaStaHvIS tIgh commands.\r\nleave blank default subject tlhegh lo'.
Success	Qapla'
Failed	luj
Cancelled	qIl
Download fail	luj download
Limit processor utilization	vuS processor utilization
Check this to limit the number of logical processors that MCEBuddy can use.\r\nEach check box below corresponds to an available logical processor.	check corresponds logical processors, use.\r\neach check box below laH mcebuddy mI' vuS lupoQ logical processor.
Custom profile	tIgh qoghDu'DajDaq
If you have a custom profiles.conf file that you want to use instead of the\r\none that comes with MCEBuddy, enter the path to the file here.\r\n\r\nNOTE: MCEBuddy constantly updates profiles.conf to provide bug fixes,\r\nenhancements and performance improvements which you will miss out\r\non if you use this feature.	tIgh profiles.conf teywI' 'e' instead of the\r\none 'ej QuQ Ha' mcebuddy lo' DaneH'a' chorDaq, path 'el teywI' here.\r\n\r\nnote: mcebuddy constantly \r\nenhancements yIqaw 'ej improvements out\r\non miss vaj feature lo' 'oH tI', updates profiles.conf ghew DuHIvDI'.
Invalid custom profiles.conf	invalid profiles.conf tIgh
Suspend on battery	suspend 'ul 'aplo'mey
Suspend conversions when the computer switches to battery power	conversions suspend HeghDI' 'ul 'aplo'mey HoS leQ De'wI'
MCEBuddy added a video conversion to the queue	video conversion, queue chel mcebuddy
Queue	queue
Refer to documentation on using custom commands in custom eMail subjects	refer documentation tIgh ra' lo' tIgh eMail subjects
Could not copy information to Clipboard, please try again.	laH wej De' copy Clipboard, nID bel jatlhqa'.
Error copying to Clipboard	Qagh copying Clipboard
Copy to clipboard	copy clipboard
Reconvert files	teywI' reconvert
Are you sure you want to reconvert the selected files?	SoH be wIv teywI' reconvert DaneH'a'?
Select the files you want to reconvert and then click this button.\r\nIf the original files are still being monitored by MCEBuddy they will be queued for reconversion.	teywI' reconvert 'ej vaj button.\r\nif jIH teywI' original pong mcebuddy queued chaH reconversion click DaneH'a' wIv.
Time taken to convert	ghaH bIDameH poH
Network authentication	network authentication
Click the button to enter the network shares credentials.\r\nThis authentication is used when files are added via the Add button on the main window\r\nor dragged and dropped from a network share into the conversion status box on the main window.	dragged 'ej chagh vo' network SoH conversion Dotlh box Qorwagh 'elbogh vaj yIlo' network SoH credentials.\r\nthis authentication 'el button HeghDI' chel teywI' chel button 'elbogh window\r\nor via click.
Skip reconversion	skip reconversion
Do not reconvert the video if a converted file already exists in the destination directory.	wej video reconvert vaj chonayta' nIv'e' qaStaHvIS ghoch directory bIDameH teywI'.
The expected filename for the converted video (not the original video filename) is compared with the filenames in the destination directory.\r\nIf the converted file exists, the file will not be reconverted and it will be assumed to be a successful conversion.\r\nThis is useful if the same show/episode is being recorded on multiple times and you don't want to reconvert them.\r\n\r\nNOTE: This option is ignored for videos that are added manually using the add button or dragging and dropping	'e' filename compared bIDameH video (wej original video filename) ghoch directory.\r\nif nIv'e' bIDameH teywI' filenames ghaH, wej reconverted teywI' 'ej 'e' successful conversion.\r\nthis lI' ta rap cha' ghap episode multiple poH 'ej reconvert them.\r\n\r\nnote ghewmey DaneH'a' assumed 'oH: buSHa' DuH videos 'ej QuQ chel manually chel button lo' pagh dragging 'ej chagh
If enabled, skip reconversion will also check the history file for past conversions.\r\nThe expected filename for the converted video (not the original video filename) is compared with the filenames in the history file.\r\nIf the to be converted filename (including path) matches any of the already converted filenames (including paths) in the history file,\r\nthe file will not be reconverted and it will be assumed to be a successful conversion.	vaj enabled, qun teywI' je check skip reconversion compared filename bIDameH video (wej original video filename) qun file.\r\nif filenames, qatlh pIHbe' jIvumlI' conversions.\r\nthe qul chonayta' bIDameH filenames DaH (paths nobvam) qaStaHvIS qun teywI' vIvoqHa' naQmey 'e' bIDameH filename DaH (path nobvam), wej reconverted \r\nthe teywI' 'ej assumed 'oH 'e' successful conversion.
Adding file to the iTunes library	teywI' chel be'nI''a'wI', itunes Datu'
Add to iTunes	chel itunes
Check this box to automatically add the converted files to the iTunes library.\r\nThis only works with iTunes supported files (e.g. MP4, M4V, MP3 etc)	teywI' (e.g. mp4, m4v, mp3 etc) Qutlh neH Qap itunes box automatically bIDameH teywI' chel itunes library.\r\nthis check
Adding file to the WMP library	teywI' chel be'nI''a'wI', wmp Datu'
Library Management	be'nI''a'wI', Datu' Management
Add to Windows Media Player	chel windows media DawI'pu'
Check this box to automatically add the converted files to the WMP library.	check box automatically bIDameH teywI' chel be'nI''a'wI', wmp Datu'.
Renaming and Sorting	renaming 'ej Segh
Selection Filters	selection Filters
Audio and Video	audio 'ej Video
Subtitles and Chapters	subtitles 'ej Chapters
Skip copying original files	skip copying original teywI'
CHECK THIS BOX AT YOUR OWN RISK.\r\nDO NOT CHECK THIS BOX UNLESS YOU KNOW WHAT YOU ARE DOING.\r\nCheck this box to skip making a backup of original file (copying) while converting.	CHECK ghu'vam BOX legh lach'eghDI' risk.\r\ndo wej CHECK ghu'vam BOX ghaH'e' SoHbe'chugh SoH Sov nuq SoH ARE doing.\r\ncheck box skip original teywI', (copying) chach chenmoH poStaHvIS bIDameH.
CHECK THIS BOX AT YOUR OWN RISK.\r\nDO NOT CHECK THIS BOX UNLESS YOU KNOW WHAT YOU ARE DOING.\r\nCheck this box to skip making a backup of original file (copying) while converting.\r\nIf this is checked, the original file will not be preserved in case of an error.\r\nIt can also even lead to conversion failures or other unforeseen conversion issues.	ghaH'e' SoHbe'chugh nuq doing.\r\ncheck checked chenmoH chach original teywI', (copying) poStaHvIS converting.\r\nif skip box, wej choq teywI' original in case of error.\r\nit DaSov laH je vabDot Dev CHECK ghu'vam BOX legh lach'eghDI' risk.\r\ndo wej BOX CHECK conversion failures pagh wanI'vammo' latlh unforeseen conversion tlha'.
Are you sure you want to do this?	be DaneH'a'?
Media Information Management	media De' Management
Force show type	raD cha' Segh
Set this to force treating the video recording as a Movie or TV Series.\r\nThis will change the way additional information (metadata) about the recording is downloaded from the internet.\r\nMovie - Treat the recording as movie\r\nSeries - Treat the recording as a TV Series\r\nSports - Treat the recording as a Sports show\r\nDefault - Use the default information available in the recording metadata to determine Movie or TV Series	pIqar video ta Movie treating raD HIjmeH pagh law' Sports show\r\ndefault-malja' bIr mIw wIje'laHbe'chugh vaj default De' lupoQ qaStaHvIS recording metadata qIlmeH pIj Movie tv Series pagh recording choH mIw-Treat movie\r\nseries-Treat je tv series\r\nsports recording je recording-Treat downloaded vo' internet.\r\nmovie Saturjaj De' (metadata) umqu' ghot recording tv series.\r\nthis
Show type	cha' Segh
Select this to filter the type of recordings being converted.\r\n\r\nMovies - select this to convert if the show type is Movie.\r\nShows - select this to convert if the show type is NOT a Movie.\r\nSports - select this to convert if the show type is Sports.\r\n\r\nNOTE: Show type is read from the recording metadata.\r\nOnly some recordings support show type metadata such as WTV and\r\nrecordings with supporting metadata files (XML/ARG etc).	pIqar Segh converted.\r\n\r\nmovies recordings filter wIv-pIqar bIDameH vaj cha' Segh movie.\r\nshows-pIqar bIDameH vaj cha' Segh 'oHbe' movie.\r\nsports-bIDameH vaj cha' Segh sports.\r\n\r\nnote wIv wIv wIv: cha' laD Segh vo' recording metadata.\r\nonly Qutlh 'op recordings (teywI' cha' Segh metadata such as wtv and\r\nrecordings metadata Qutlhxml/arg etc).
This box shows all the files in queue for conversion.\r\nDrag and drop files here or press the Add button to add files to the conversion queue	teywI' Hoch cha' box qaStaHvIS queue conversion.\r\ndrag chagh 'ej teywI' naDev press chel button teywI' chel conversion queue pagh
Conversion	conversion
Files	teywI'
Click this button to open or close the Advanced Settings section	poS pagh 'Itlh Settings 'ay' SoQ button click
Running custom commands	qet tIgh ra'
Trimming video recording	video recording chIp
Insert at top of queue	insert DeSDu' queue yor
By default, new conversions are added to the bottom (end) of the conversion queue.\r\nIf this box is checked, any new conversions added by this task will be added to the\r\nbeginning (top) of the conversion queue.	pong default, chel chu' conversions bIngDaq pe'lu' (van) conversion queue.\r\nif checked box, chel vay' chu' conversions chel Qu' the\r\nbeginning bIr mIw wIje'laHbe'chugh vaj (yor) conversion queue.
Add subtitles and chapters	subtitles chapters 'ej chel
Enable this option to add any extracted subtitles and chapters to the converted video.\r\nEach chapter marks the end of a commercial. This only works with supported formats (e.g. MKV, MP4).\r\n\r\nNOTE: Some players and older TV's don't support embedded subtitles and chapters.\r\nIf you're unable to playback the converted video's, try turning this option off.	DuH chel vay' extract subtitles enable 'ej commercial van ghItlh bIDameH video.\r\neach chapter chapters. neH vum ghaH formats Qutlh (e.g. mkv, mp4).\r\n\r\nnote: embed subtitles ghewmey Qutlh DawI'pu' older tv 'ej 'op 'ej chapters.\r\nif playback bIDameH video unable, DuH tlhe' 'e' nID.
Select best soundtrack	Qaghbe'meH soundtrack wIv
If the original video has multiple soundtracks, this option tells MCEBuddy to select the most appropriate and primary soundtrack.\r\nIf you want a specific language soundtrack, make sure you enter the language name or code in the Audio Language box.\r\nCheck this box if you're hearing the wrong soundtrack in your converted file.\r\n\r\nUncheck this box if you want MCEBuddy to retain all the soundtracks from the original video in the converted file when possible.\r\nNOTE:Some profiles do not support multiple soundtracks, in which case this setting has no effect.	'IjmeH multiple soundtracks, original video mcebuddy jatlh DuH appropriate: reH 'ach 'ej primary soundtrack.\r\nif specific Hol soundtrack DaneH'a' wIv, chenmoH be ta' Hol pong 'el pagh box ngoq qaStaHvIS Audio Hol box.\r\ncheck vaj box Duja'ba'pu' QIH soundtrack qaStaHvIS bIDameH file.\r\n\r\nuncheck vaj mcebuddy Hoch soundtracks original video qaStaHvIS bIDameH teywI' HeghDI' qIt vo' retain DaneH'a' SoH. \r\nnote: multiple soundtracks, wej Qutlh 'op qoghDu'DajDaq je baS case pagh 'angbogh Da ghaj setting.
Enable remote access	naw' Hop enable
This creates an exception in the windows firewall for MCEBuddy application and the port.\r\nThis is required if you have windows firewall enabled and want to use UPnP, the remote client\r\nor access the engine using an IP address.\r\n\r\nNOTE: If you have a custom firewall, this may not work, you will need to manually create an\r\nexception for MCEBuddy service and the port.	lurIHbogh chenmoH qaStaHvIS Qorwagh firewall mcebuddy application 'ej port.\r\nthis poQ vaj ghaj Qorwagh firewall enabled 'ej upnp, client\r\nor Hop naw' lo' QuQ address.\r\n\r\nnote ip lo' neH: firewall tIgh chorDaq, chaq wej Qap, manually mcebuddy chavmoH an\r\nexception 'ej rut mutlha'taH chenmoH bImejnIS.
Unable to communicate with engine. Firewall exception settings have not been updated.	unable jatlhmeH QuQ. wej updated firewall lurIHbogh settings.
Detect and optimize video quality	detect 'ej video laHlIj optimize
When enabled, MCEBuddy will optimize the video processing options by trying to detect the video source type.\r\nThis can improve the quality of the converted video significantly if correctly detected.\r\n\r\nNOTE: It does this by trying to detect the video source type (interlaced, progressive or telecine).\r\nIf it is able to detect the video source type, it will override the corresponding parameters in the profile.\r\nTurn this option off if you are facing issues with converted video quality or want to use the default profile parameters.	HeghDI' enabled, video processing DuH optimize mcebuddy pong 'e' bIDameH video laHlIj laH Dub Hal video type.\r\nthis significantly vaj correctly detect detected.\r\n\r\nnote: Qu' 'oH pong 'e' video Hal Segh (interlace, progressive pagh telecine).\r\nif vay' video Hal Segh detect detect, correspond parameters qaStaHvIS DuH DoH vaj wanI'vammo' tlha' bIDameH video laHlIj qaD pagh default qoghDu'DajDaq parameters lo' neH SoH profile.\r\nturn ngep 'oH.
Are you sure you want to delete this task?	be Qu' delete DaneH'a'?
Delete Task	Qu' delete
Enter the new task name	chu' Qu' pong 'el
Rename Task	Qu' rename
MCEBuddy PAUSED	yev mcebuddy
idle	pagh vIbuSlaw' 'e' vI'angnIS
PAUSED	YEV
Frame rate	Dalbogh rate
Enable this to set a custom framerate (FPS) for the converted video.\r\nYou may need to set this while converting video formats (e.g. PAL to NTSC)\r\nor for devices which support only specific framerates.\r\n\r\nE.g.: 25\r\nE.g.: 30000/1001	tIgh framerate (FPS) HIjmeH HIjmeH poStaHvIS video formats (e.g. maqoch ntsc) \r\nor lIngmeH jan specific neH framerates.\r\n\r\ne.g. Qutlh 'oH bIDameH chaq nIS bIDameH video.\r\nyou enable: 25\r\ne.g.: 30000 ghap 1001
Skip remuxing files	skip remuxing teywI'
CHECK THIS BOX AT YOUR OWN RISK.\r\nDO NOT CHECK THIS BOX UNLESS YOU KNOW WHAT YOU ARE DOING.\r\nCheck this box to skip remuxing the original file to a TS file while converting.\r\nIf this is checked, some functions like subtitle extraction or comskip may not work.\r\nIt can also even lead to conversion failures or other unforeseen conversion issues.	laH je vabDot Dev CHECK ghu'vam BOX legh lach'eghDI' risk.\r\ndo wej BOX ghaH'e' SoHbe'chugh work.\r\nit wej boQubneS Sov nuq doing.\r\ncheck box rut teywI' poStaHvIS checked converting.\r\nif skip remuxing teywI' original, subtitle extraction comskip joq Qap 'op CHECK conversion failures pagh wanI'vammo' latlh unforeseen conversion tlha'.
CHECK THIS BOX AT YOUR OWN RISK.\r\nDO NOT CHECK THIS BOX UNLESS YOU KNOW WHAT YOU ARE DOING.\r\nCheck this box to skip remuxing the original file to a TS file while converting.	CHECK ghu'vam BOX legh lach'eghDI' risk.\r\ndo wej CHECK ghu'vam BOX ghaH'e' SoHbe'chugh SoH Sov nuq SoH ARE doing.\r\ncheck box skip remuxing teywI' original muDvo' teywI' poStaHvIS bIDameH.
Monitor converted videos	bIDameH videos jIH
By default Monitor Locations will ignore files that have already been converted.\r\nCheck this box if you also want to monitor converted files in the Monitor Path.\r\nCAUTION: This can lead to an infinite conversion loop of converted files if not configured properly.\r\n\r\nThis can be useful when you are specifying the output directory of a conversion task\r\n(converted file) as the Monitor Path of a Monitor Location and linking the\r\nMonitor Location to another conversion task.	pong default box buSHa' teywI' 'ej QuQ 'e' chonayta' converted.\r\ncheck jIH Locations vaj bIDameH teywI' qaStaHvIS jIH path.\r\ncaution jIH je DaneH'a': laH Dev, 'ej infinite conversion loop bIDameH teywI' ngugh configure properly.\r\n\r\nthis laH lI' output directory conversion task\r\n (bIDameH teywI') per law' jIH Path jIH Location 'ej linking the\r\nmonitor SoH Qo'noS location Qu' conversion latlh.
CHECK THIS BOX AT YOUR OWN RISK.\r\nDO NOT CHECK THIS BOX UNLESS YOU KNOW WHAT YOU ARE DOING.\r\nBy default Monitor Locations will ignore files that have already been converted.\r\nCheck this box if you also want to monitor converted files in the Monitor Path.	box buSHa' teywI' 'ej QuQ 'e' chonayta' converted.\r\ncheck CHECK ghu'vam BOX legh lach'eghDI' risk.\r\ndo wej CHECK ghu'vam BOX ghaH'e' SoHbe'chugh SoH Sov nuq SoH ARE doing.\r\nby default jIH Locations vaj bIDameH teywI' qaStaHvIS jIH Path jIH je DaneH'a'.
Hardware encoding	hardware encoding
Check this box to use hardware encoding when available to convert videos.\r\nThis can speed up the conversion significantly and reduce the CPU utilization\r\nbut it can result in slightly lower quality videos.\r\n\r\nUncheck this box if you're facing conversion or quality issues.	check laH speed Ha' conversion significantly 'ej reduce cpu utilization\r\nbut laH ghot'e', 'ej 'oH qaStaHvIS loQ ghuS laHlIj videos.\r\n\r\nuncheck box vaj conversion laHlIj wanI'vammo' tlha' pagh qab SoH hardware encoding lo' HeghDI' lupoQ videos.\r\nthis bIDameH box.
Do not overwrite files	teywI' overwrite.
When this box is checked, the destination file will not be overwritten if it already exists.\r\nInstead a new file will be created with a unique number added to the end of the filename.	HeghDI' checked box, wej overwritten ghoch teywI' vaj chel 'oH chonayta' chenmoH exists.\r\ninstead chu' teywI' mI' unique filename pItlh.
Re-monitor recorded videos	'elqa' jIH ta videos
By default, once a source file (Recorded video) has been converted,\r\nthe monitor history will track the filename and not queue the same files again.\r\n\r\nEnable this option to ignore the history and monitor all files and add them to\r\nthe conversion queue, even if they have already been converted.\r\n\r\nThis can be useful sometimes, if the recording software does not generate a\r\nunique filename for each episode/show. It is reccomended to use the\r\nDelete original file option in the Settings page when using this option to avoid\r\nan infinite conversion loop.	pong default, QInvam wa'logh bIDameH Hal teywI' (recorded video), DuH qun buSHa' 'ej Hoch teywI' jIH 'ej to\r\nthe conversion queue chel chaH ghoch filename 'ej wej queue rap teywI' again.\r\n\r\nenable \r\nthe jIH qun, vabDot chonayta' chaH converted.\r\n\r\nthis laH lI' rut, vaj a\r\nunique filename Hoch episode ghap cha' wej generate recording software. reccomended the\r\ndelete original teywI' DuH lo' qaStaHvIS Settings page lo'lu'DI' DuH avoid\r\nan infinite conversion loop.
Recommendation	recommendation
To avoid an infinite conversion loop, it is recommended to setup your Monitor search pattern in a way such as to ensure that the converted files are not being monitored by this Monitor task.	loop infinite conversion webqu'meH nov, chup 'oH jIH search pattern qaStaHvIS wIqelchugh mIw setup lulIngmeH 'e' wej jIH bIDameH teywI' pong jIH Qu'.
CHECK THIS BOX AT YOUR OWN RISK.\r\nDO NOT CHECK THIS BOX UNLESS YOU KNOW WHAT YOU ARE DOING.\r\nBy default Monitor Locations will not remonitor recorded videos that have been processed.\r\nCheck this box if you want to remonitor and reconvert the recorded videos.	box ta videos 'ej QuQ 'e' processed.\r\ncheck CHECK ghu'vam BOX legh lach'eghDI' risk.\r\ndo wej CHECK ghu'vam BOX ghaH'e' SoHbe'chugh SoH Sov nuq SoH ARE doing.\r\nby default wej remonitor jIH Locations vaj remonitor 'ej ta videos reconvert DaneH'a'.
To avoid an infinite conversion loop, it is recommended that you enable Delete original file option in the Settings page.	loop infinite conversion webqu'meH nov, Delete original teywI' DuH qaStaHvIS Settings page enable chup 'oH.
Prioritize air date matching	prioritize jejlaw' date qul naQmey
MCEBuddy uses the episode name to match the series information\r\nwhile searching the internet. If that fails then it uses the original broadcast\r\nair date to match the metadata.\r\n\r\nCheck this box to use the original broadcast air date first and then the\r\nepisode name to match for the series information from the internet.\r\nThis can be useful in some cases when multiple seasons have the same\r\nepisode name. E.g. Americal Idol, Audition 1\r\n\r\nNOTE: Original broadcast air date is not always accurate set by the\r\nbroadcaster and sometimes the information on the internet is incorrect.\r\nUse this option only if the default option is not working for you.	episode pong DanoHmeH mcebuddy qul naQmey series information\r\nwhile internet searching. luj vaj box original broadcast jejlaw' date lo' wa'DIch DanoHmeH original broadcast\r\nair date qul naQmey metadata.\r\n\r\ncheck 'oH 'ej vaj the\r\nepisode pong series De' vo' internet.\r\nthis qul naQmey laH lI' qaStaHvIS 'op cases HeghDI' same\r\nepisode pong ghaj multiple maqtagh. e.g. Americal Ho', Audition 1\r\n\r\nnote: Original ta' jejlaw' broadcast date 'oHbe' reH qar HIjmeH pong the\r\nbroadcaster 'ej rut internet De' incorrect.\r\nuse DuH neH vaj wej baj default DuH SoH.
Skip eMail body	skip eMail lom
Check this option to use an empty body in the notification eMail.\r\nThis can be useful if you're using a SMS gateway for eMail notifications.	DuH lom chIm lo' qaStaHvIS notification email.\r\nthis laH lI' sms gateway lo' SoH eMail notifications vaj law' check.
Selection based on Digital Right Management (DRM) is available\r\nonly when Rename without converting (Rename and move only) option is selected.\r\n\r\nAll - Selects all files for processing, irrespective of copy protection status\r\nProtected - Only select files which are copy protected\r\nUnprotected - Only select files which do not have copy protection	waw' Digital nIH Management ((drm)) selection available\r\nonly ghorgh Rename Hutlh bIDameH (Rename 'ej neH vIH) DuH-wIv Hoch teywI' processing mIw vIlIj, 'ej irrespective of copy protection status\r\nprotected-selected.\r\n\r\nall neH copy protected\r\nunprotected be'ghomDaq teywI' wIv-neH wIv teywI' 'ej QuQ copy protection jechlaHbe'bogh.
Download cover art	download yuvtlhe' SoH'a'
Enable this to download the cover art from the original video and internet if available.	pIqar yuvtlhe' SoH'a' download original video 'ej internet vaj lupoQ enable.
Are you sure you want to enter a Domain Name?\r\n\r\nUse this ONLY if you are using a Windows Domain Controller to manage your authentication.\r\nDo NOT use this if you are part of a Workgroup.\r\n\r\nIf you are unsure click NO.	be yer pong 'el DaneH'a'? \r\n\r\nuse neH vaj windows yer Controller DanoHmeH SoH vu' wej yIlo' authentication.\r\ndo vaj workgroup.\r\n\r\nif 'ay' unsure click Qo'
Configuration Warning	configuration Warning
Creates a folder called 'MCEBuddyArchive' where the original file is located\r\nand moves the orginal file in this directory after a successful conversion.\r\n\r\nThis folder name and location be changed below.	folder mcebuddyarchive nuqDaq teywI' original orginal teywI' qaStaHvIS directory vIH located\r\nand qaSpu'DI' choH 'ej location successful conversion.\r\n\r\nthis folder pong below pong chenmoH.
Monitoring	jIH
If you want to convert the EDL file into chapters, make sure you check the 'Add Subtitles and Chapters' option in Expert Settings.	vaj edl teywI' bIDameH vaj chapters DaneH'a', chenmoH be chel Subtitles 'ej Chapters DuH qaStaHvIS po' Settings check.
EDL to Chapters	edl Chapters
