MCEBuddy does NOT use the currently logged in user to connect to network shares, it uses its own service account.  Be sure to specify the connection user information (MCEBuddy with a key icon)	MCEBuddy không sử dụng hiện đang đăng nhập người sử dụng để kết nối với mạng chia sẻ, nó sử dụng tài khoản dịch vụ riêng của mình.  Hãy chắc chắn để xác định thông tin người dùng kết nối (MCEBuddy với một biểu tượng chủ chốt)
Connection Reminder	Kết nối Reminder
Description	Mô tả
Path	Đường dẫn
is invalid	không hợp lệ
Invalid Path	Đường dẫn không hợp lệ
Please supply a task name	Xin vui lòng cung cấp một tên tác vụ
No name supplied	Không có tên được cung cấp
Please enter the 3 digit language code of the Audio track or select <Default> or <Original>	Vui lòng nhập mã ngôn ngữ 3 chữ số theo dõi âm thanh hoặc chọn <Default>hoặc <Original>
The 3 digit ISO code for the selected language\r\nMake sure this matches the language code for the audio track in the original recording.\r\nTo get the language code for the audio tracks in the original recorded file, add the file\r\nto the queue and right click on it. A pop up window will open showing the audio details\r\nwhich include the language codes for each audio track.	3 Chữ số mã ISO đã chọn language\r\nMake chắc chắn điều này phù hợp với mã ngôn ngữ cho Rãnh âm thanh trong bản gốc recording.\r\nTo lấy mã ngôn ngữ cho các bài hát âm thanh trong các tập tin được ghi lại ban đầu, thêm file\r\nto hàng đợi và kích chuột phải vào nó. Một cửa sổ pop up cửa sổ sẽ mở hiển thị những âm thanh details\r\nwhich bao gồm các ngôn ngữ mã cho mỗi rãnh âm thanh.
Invalid Language Code	Mã ngôn ngữ không hợp lệ
No destination directory provided, converted file will be placed in original video directory	Không có thư mục đích cung cấp, chuyển đổi tập tin sẽ được đặt trong thư mục gốc của video
A task name or section	Tên tác vụ hoặc phần
already exists\n\rPlease use another name	đã exists\n\rPlease sử dụng tên khác
Duplicate Name	Trùng lặp tên
Engine	Động cơ
Tasks	Nhiệm vụ
Profile	Hồ sơ
disposing	việc xử lý
Task name	Tên tác vụ
Give a unique name to this task	Cung cấp một tên duy nhất cho nhiệm vụ này
Gives a short description for the selection conversion profile	Cho một mô tả ngắn cho hồ sơ chuyển đổi lựa chọn
Click to select destination folder	Nhấn vào đây để chọn cặp đích
Destination	Điểm đến
Select the directory where the converted file will be placed.\r\nLeave this blank to keep the converted file in the same directory as the original video.	Chọn thư mục nơi mà các tập tin chuyển đổi sẽ là placed.\r\nLeave này trống để giữ các tập tin chuyển đổi trong các thư mục tương tự như bản gốc video.
Max width	Tối đa chiều rộng
This will limit the maximum width (in pixels) of the video for the converted file.\r\nTIP: Does not apply if the original file has a width smaller than this number.\r\nIf you want to keep your original video resolution move the slider all the way to the right.	Điều này sẽ hạn chế chiều rộng tối đa (theo điểm ảnh) của video chuyển đổi file.\r\nTIP: không áp dụng nếu tệp gốc có chiều rộng nhỏ hơn so với này number.\r\nIf bạn muốn giữ di chuyển video độ phân giải ban đầu của bạn thanh trượt tất cả các đường bên phải.
Quality	Chất lượng
Ad remover	Quảng cáo remover
None	Không có
Get series details from Internet	Nhận được chi tiết loạt từ Internet
Download additional details about the movie or series from the internet	Thêm chi tiết về bộ phim hay loạt tải về từ internet
File name match	Phù hợp với tên tập tin
Recording title match	Trận đấu tiêu đề ghi âm
Cancel	Hủy bỏ
OK	Ok
Rename without converting	Đổi tên mà không cần chuyển đổi
Check this option to only rename and copy the original files to the destination folder.\r\nWhen checked, conversion, trimming, audio/video processing and commercial removal will not be available.\r\n\r\nNOTE: Other functions like matching filters, extracting subtitles, saving metadata and commercial detection (saving EDL file)\r\nwill still be available with this option checked.\r\nIf you want to move instead of copy, check the Skip copying original option in Expert Settings on this page or select\r\nDelete original file in the main settings page.	Kiểm tra tuỳ chọn này để chỉ đổi tên và sao chép các tập tin ban đầu để folder.\r\nWhen đích kiểm tra, chuyển đổi, trang trí, xử lý âm thanh/video và loại bỏ thương mại sẽ không là available.\r\n\r\nNOTE: các chức năng như phù hợp với bộ lọc, trích xuất phụ đề, tiết kiệm siêu dữ liệu và thương mại phát hiện (tiết kiệm EDL tập tin) \r\nwill vẫn còn có sẵn với này checked.\r\nIf tùy chọn bạn muốn di chuyển thay vì sao chép, kiểm tra bỏ qua sao chép bản gốc tùy chọn trong cài đặt chuyên gia này hồ sơ ban đầu trang hoặc select\r\nDelete trong trang cài đặt chính.
Rename and sort by video information	Đổi tên và sắp xếp theo thông tin video
Renames the converted file and places it in a new directory based on the show/series information when available\r\n(e.g. ShowName\\ShowName-SXXEYY-EpisodeName-RecordDate)	Đổi tên các tập tin chuyển đổi và đặt nó trong một thư mục mới dựa trên các thông tin hiển thị/series khi available\r\n (ví dụ như ShowName\\ShowName-SXXEYY-EpisodeName-RecordDate)
Enter the username and password to access folders that are on a network drive or a different computer	Nhập tên người dùng và mật khẩu để truy cập các thư mục trên ổ đĩa mạng hoặc máy tính khác nhau
Organize by seasons	Tổ chức theo mùa
Organize folders by Showname and Season when available (Media Center/XBMC/Plex compatible naming convention)\r\n(e.g. Showname\\Season XX\\SXXEYY-Episode Name)	Tổ chức thư mục của Showname và mùa khi có sẵn (Media Center/XBMC/Plex tương thích quy ước đặt tên) \r\n (ví dụ như Showname\\Season XX\\SXXEYY-tập tên)
Audio language	Âm thanh ngôn ngữ
Advanced Settings	Thiết đặt chuyên sâu
General Settings	Cài đặt chung
Conversion Task	Chuyển đổi công việc
Password	Mật khẩu
Confirm Password	Xác nhận mật khẩu
Domain / computer name	Tên miền / tên máy tính
<Optional> Enter if remote computer or network drive uses a Domain for authentication.\r\nDo NOT enter your workgroup here. Leave this blank if you're using a workgroup.	<Optional>Enter nếu ổ đĩa từ xa máy tính hoặc mạng sử dụng một tên miền cho authentication.\r\nDo không tham dự các nhóm làm việc của bạn ở đây. Điều này để trống nếu bạn đang sử dụng một nhóm làm việc.
User name	Tên người dùng
Enter the username to access the remote computer or network drive	Nhập tên người dùng để truy cập vào ổ đĩa máy tính hoặc mạng từ xa
Enter the password to access the remote computer or network drive	Nhập mật khẩu để truy cập vào ổ đĩa máy tính hoặc mạng từ xa
Network Connection User Credentials	Chứng chỉ người dùng kết nối mạng
Password Mismatch	Mật khẩu Mismatch
Passwords do not match, please reenter the passwords	Mật khẩu không khớp, vui lòng nhập lại mật khẩu
Hour	Giờ
Minute	Phút
Wake	Trỗi dậy
Start	Bắt đầu
Resume	Tiếp tục
Pause	Tạm dừng
Stop	Dừng
Language	Ngôn ngữ
Pause conversion tasks	Tạm dừng chuyển đổi nhiệm vụ
Resume conversion tasks	Tiếp tục nhiệm vụ chuyển đổi
Please enter a valid time	Vui lòng nhập một thời gian hợp lệ
Invalid Time	Thời gian không hợp lệ
Stop time is after Start time. Assuming the Stop time is during the next day, is that correct?	Thời gian dừng lại là sau khi thời gian bắt đầu. Giả sử thời gian dừng lại là trong ngày hôm sau, là chính xác những gì?
Time Check	Kiểm tra thời gian
Only select this option if MCEBuddy has been converting your files reliably for an acceptable period of time. Do you wish MCEBuddy to delete each original file once it has been converted?	Chỉ chọn tùy chọn này nếu MCEBuddy đã chuyển đổi tập tin của bạn đáng tin cậy trong một thời gian chấp nhận được. Bạn có muốn MCEBuddy để xóa từng tệp gốc một khi nó đã được chuyển đổi?
Confirm delete originals?	Xác nhận xóa bản gốc?
MCEBuddy will monitor these directories for video files to convert automatically	MCEBuddy sẽ quản lý các thư mục cho tệp video để chuyển đổi tự động
Conversion tasks	Chuyển đổi công việc
Delete original file	Xóa bỏ tệp gốc
Deletes the original recording after a successful conversion	Xóa ghi âm ban đầu sau khi một sự chuyển đổi thành công
Min age before conversion (hours)	Min tuổi trước khi chuyển đổi (giờ)
Minimum hours to wait before converting each file after the file is added to the queue	Tối thiểu giờ để chờ đợi trước khi chuyển đổi mỗi tập tin sau khi tập tin được thêm vào hàng đợi
Use this to change the language of the text on the screen	Sử dụng điều này để thay đổi ngôn ngữ của văn bản trên màn hình
Concurrent conversions	Đồng thời chuyển đổi
Number of simultaneous conversions MCEBuddy can start\r\nNOTE: You need large amounts of free disk space and processor time for more than 2 simultaneous conversions	Số lượng đồng thời chuyển đổi MCEBuddy có thể start\r\nNOTE: bạn cần một lượng lớn đĩa không gian và bộ vi xử lý thời gian cho chuyển đổi đồng thời nhiều hơn 2
Logging level	Mức độ đăng nhập
Error	Lỗi
Warning	Cảnh báo
Information	Thông tin
Debug	Gỡ lỗi
Log conversion jobs	Các công việc chuyển đổi đăng nhập
Save a log file for each conversion in the \'logs\' directory where where MCEBuddy is installed\r\n(e.g. C:\\Program Files\\MCEBuddy2x\\logs)	Lưu một tệp sổ ghi cho mỗi chuyển đổi trong \'logs\' thư mục nơi mà MCEBuddy là installed\r\n (ví dụ: C:\\Program Files\\MCEBuddy2x\\logs)
Allow sleep	Cho phép ngủ
If unchecked, it prevents the system from entering sleep while converting	Nếu không được kiểm soát, nó ngăn ngừa hệ thống từ đi vào giấc ngủ trong khi chuyển đổi
Stop at	Dừng lại ở
No new conversions would be started after this time	Không có chuyển đổi mới sẽ được bắt đầu sau khi thời gian này
minute	phút
hour	giờ
If checked MCEBuddy will wake the system from sleep\r\nat the specified Start time and enabled days of the week.	Nếu kiểm tra MCEBuddy sẽ đánh thức hệ thống từ sleep\r\nat thời gian bắt đầu được chỉ định và cho phép các ngày trong tuần.
Start at	Bắt đầu tại
MCEBuddy will start new conversions between the Start and Stop time.\r\n\r\nThe Start time will be used for the enabled days of the week, whereas\r\nthe End time will be used either for the same day or\r\nfor the next day if the End time is after the Start time.	MCEBuddy sẽ bắt đầu chuyển đổi mới giữa bắt đầu và ngừng time.\r\n\r\nThe bắt đầu thời gian sẽ được sử dụng để kích hoạt ngày trong tuần, whereas\r\nthe kết thúc thời gian sẽ sử dụng một trong hai cho or\r\nfor ngày cùng một ngày hôm sau nếu thời gian kết thúc sau khi thời gian bắt đầu.
Delete	Xóa bỏ
Add	Thêm
Change	Thay đổi
Archive original file	Lưu trữ tệp gốc
Domain name	Tên miền
Stops the monitor and conversion tasks and opens a page to configure MCEBuddy	Dừng lại màn hình và chuyển đổi nhiệm vụ và mở ra một trang để cấu hình MCEBuddy
Creates a folder called \'MCEBuddyArchive\' where the original file is located\r\nand moves the orginal file in this directory after a successful conversion.\r\n\r\nThis folder name and location be changed in the System Settings page.	Tạo ra một thư mục có tên \'MCEBuddyArchive\' nơi các tập tin ban đầu là located\r\nand di chuyển các tập tin gốc trong thư mục này sau khi một thành công conversion.\r\n\r\nThis thư mục tên và vị trí được thay đổi trong trang cài đặt hệ thống.
Debug - detailed logs, helps trace conversion problems\r\nInformation - logs basic information about conversion\r\nWarning - log potential issues or critical failures only\r\nError - log critical failures only	Gỡ lỗi - bản ghi chi tiết, giúp water chuyển đổi problems\r\nInformation - bản ghi cơ bản thông tin về conversion\r\nWarning - đăng nhập vấn đề tiềm năng hoặc thất bại quan trọng only\r\nError - đăng nhập thất bại quan trọng chỉ
Select the conversion profile associated with this task. The conversion profile represents the output format and quality for the converted file.\r\nHigher quality conversions take longer to convert. Reccomended Default: MP4 High Quality or MP4 Normal.\r\n\r\nTIP: Refer to the MCEBuddy Guide for advanced parameters to tweak conversion profiles or to create your own conversion profiles	Chọn cấu hình chuyển đổi liên kết với tác vụ này. Hồ sơ chuyển đổi đại diện cho các định dạng đầu ra và chất lượng về chất lượng chuyển đổi file.\r\nHigher chuyển đổi kéo dài lâu hơn để chuyển đổi. Recommended mặc định: Chất lượng cao MP4 hoặc MP4 Normal.\r\n\r\nTIP: tham khảo sách hướng MCEBuddy dẫn cho tham số tiên tiến để tinh chỉnh hồ sơ chuyển đổi hoặc tạo của riêng bạn cấu hình chuyển đổi
Select the program MCEBuddy will use to strip out any commercials while converting the video.\r\nSet to 'None' to leave the commercials in the converted video.\r\n\r\nTIP: To use ShowAnalyzer instead of Comskip, please download and install ShowAnalyzer.\r\nShow Analyzer version 1.0 and greater supported.	Chọn chương trình MCEBuddy sẽ sử dụng để loại bỏ bất kỳ quảng cáo thương mại trong khi chuyển đổi video.\r\nSet để 'Không' để lại các quảng cáo trong video.\r\n\r\nTIP chuyển đổi: để sử dụng ShowAnalyzer thay vì Comskip, xin vui lòng tải và cài đặt ShowAnalyzer.\r\nShow Analyzer Phiên bản 1.0 và lớn hơn được hỗ trợ.
Used to change the video quality of the converted file, normal is 1.\r\nA higher number will improve quality but will take more time for conversion.\r\nA smaller number will reduce the quality but speed up the conversion.	Được sử dụng để thay đổi chất lượng video của tập tin chuyển đổi, bình thường là 1.\r\nA số cao hơn sẽ cải thiện chất lượng nhưng sẽ mất nhiều thời gian để conversion.\r\nA số lượng nhỏ hơn sẽ làm giảm chất lượng nhưng đẩy nhanh việc chuyển đổi.
Enter pattern to match filenames for this task (e.g. *.wtv will convert all files ending with .wtv)\r\nPrefix pattern with ~ to skip the match (e.g. *.*;~*.wtv will process all files except those ending with .wtv)\r\nSeparate multiple patterns with ; (e.g. *.wtv;ncis*;~ncis miami*) will process all .wtv files and all files starting with ncis but not those starting with ncis miami\r\n\r\nYou can use regular expressions to match the pattern by starting with regex:	Nhập các mô hình để phù hợp với tên tập tin cho công việc này (ví dụ như *.wtv sẽ chuyển đổi tất cả các file kết thúc với .wtv)\r\nprefix mẫu với ~ để bỏ qua các trận đấu (ví dụ: *. *; ~*.wtv sẽ xử lý tất cả các file ngoại trừ những người kết thúc với .wtv)\r\nseparate nhiều mẫu với; (ví dụ: *.wtv; ncis *; ~ ncis miami *) sẽ xử lý tất cả các tập tin .wtv và tất cả các tệp bắt đầu với ncis nhưng không phải là những người bắt đầu với ncis miami\r\n\r\nYou có thể sử dụng biểu thức thông thường để phù hợp với các mô hình bằng cách bắt đầu với regex:
Enter pattern to match show/series titles for this task (e.g. Simpson* will convert all files that have a show title starting with Simpson)\r\nPrefix pattern with ~ to skip the match (e.g. *;~Simpson* will process all show titles except those that start with Simpson)\r\nSeparate multiple patterns with ; (e.g. Simpson*;House*) or (e.g. Simpson*;NCIS*;~NCIS Miami*)\r\n\r\nYou can use regular expressions to match the pattern by starting with regex:	Nhập các mô hình để phù hợp với Hiển thị/series tiêu đề cho nhiệm vụ này (ví dụ như Simpson * sẽ chuyển đổi tất cả các file mà có một tiêu đề Hiển thị bắt đầu với Simpson) \r\nPrefix mô hình với ~ để bỏ qua các trận đấu (ví dụ: *; ~ Simpson * sẽ xử lý tất cả Hiển thị tiêu đề ngoại trừ những người bắt đầu với Simpson) \r\nSeparate nhiều mô hình với; (ví dụ như Simpson *;House*) hoặc (ví dụ như Simpson *;NCIS*; ~ NCIS Miami *) \r\n\r\nYou có thể sử dụng biểu thức thông thường để phù hợp với các mô hình bằng cách bắt đầu với regex:
This can be used to override the default Audio Language when there are multiple audio languages in a recording.\r\nTo get the list of the Audio Languages in a recording, right click on the file in the queue and select MediaInfo.\r\n\r\n<Default> will try to keep all audio tracks if supported or let the encoder choose the default audio track\r\n<Original>, if available, will use the original [non-dubbed] recording language	Điều này có thể được sử dụng để ghi đè mặc định ngôn ngữ âm thanh khi có rất nhiều âm thanh ngôn ngữ trong một recording.\r\nTo nhận được danh sách các ngôn ngữ âm thanh trong một ghi âm, nhấp chuột phải vào tập tin trong hàng đợi và chọn MediaInfo.\r\n\r\n <Default>sẽ cố gắng giữ cho tất cả âm thanh nếu được hỗ trợ hoặc để cho mã hóa chọn mặc định âm thanh track\r\n <Original>, nếu có, sẽ sử dụng ngôn ngữ [không gọi là] ghi âm ban đầu
Enter '[video]' or leave blank to convert all video files\r\nEnter pattern to match filenames for this location (e.g. *.wtv will convert all files ending with .wtv)\r\nPrefix pattern with ~ to skip the match (e.g. *.*;~*.wtv will process all files except those ending with .wtv)\r\nSeparate multiple patterns with ; (e.g. *.wtv;ncis*;~ncis miami*) will process all .wtv files and all files starting with ncis but not those starting with ncis miami	Nhập '[video]' hoặc để trống để chuyển đổi tất cả các video files\r\nEnter mô hình để phù hợp với tên tập tin cho vị trí này (ví dụ như *.wtv sẽ chuyển đổi tất cả các tập tin kết thúc bằng mô hình .wtv)\r\nprefix với ~ để bỏ qua các trận đấu (ví dụ như *. *; ~*.wtv sẽ xử lý tất cả các file ngoại trừ những người kết thúc với .wtv)\r\nseparate các mô hình nhiều với; (ví dụ như *.wtv; ncis *; ~ ncis miami *) sẽ xử lý tất cả các tập tin .wtv và tất cả các tệp bắt đầu với ncis nhưng không phải những người bắt đầu với ncis miami
MCEBuddy Settings	Cài đặt MCEBuddy
MCEBuddy does NOT use the currently logged in user to connect to network shares, it uses its own service account.  Be sure to specify the connection user information [MCEBuddy with a key icon]	MCEBuddy không sử dụng hiện đang đăng nhập người sử dụng để kết nối với mạng chia sẻ, nó sử dụng tài khoản dịch vụ riêng của mình.  Hãy chắc chắn để xác định thông tin người dùng kết nối [MCEBuddy với một biểu tượng chủ chốt]
Please supply a source name	Xin vui lòng cung cấp một nguồn tên
Please supply a search path name	Xin vui lòng cung cấp tên đường dẫn tìm kiếm
A source name or section	Một nguồn tên hoặc phần
already exists. Please use another name	đã tồn tại. Hãy dùng tên khác
Monitor name	Màn hình tên
Give this a location a unique name	Cung cấp cho điều này vị trí một tên duy nhất
Monitor path	Đường dẫn màn hình
Select the directory that MCEBuddy will monitor in the background for new video files to convert automatically	Chọn thư mục MCEBuddy sẽ giám sát phía sau cho mới file video chuyển đổi tự động
Click to select the folder to monitor	Nhấn vào đây để chọn cặp để giám sát
Search pattern	Tìm kiếm mô hình
SourceForm	SourceForm
Monitor Location	Vị trí giám sát
Normal	Normal
MCEBuddy GUI: pipeProxy engine connection error	MCEBuddy GUI: lỗi kết nối pipeProxy công cụ
MCEBuddy GUI: Unable to create pipe to MCEBuddy service	MCEBuddy GUI: Không thể tạo ống với dịch vụ MCEBuddy
The MCEBuddy service is unavailable. Please start from Windows control panel or check engine connection.	Dịch vụ MCEBuddy có sẵn. Xin vui lòng bắt đầu từ Pa-nen điều khiển Windows hoặc kiểm tra động cơ kết nối.
Announcement	Thông báo
New version 	Phiên bản mới 
available	có sẵn
New BETA version 	Phiên bản BETA mới 
Click here to download new version of MCEBuddy	Click vào đây để tải về phiên bản mới của MCEBuddy
Click here to open link	Click vào đây để mở liên kết
Idle	Nhàn rỗi
Closing	Đóng cửa
MCEBuddy GUI: Unable to update tasks	MCEBuddy GUI: Không thể cập nhật nhiệm vụ
MCEBuddy GUI: Unable to start MCEBuddy service	MCEBuddy GUI: Không thể khởi động dịch vụ MCEBuddy
MCEBuddy GUI: Unable to stop MCEBuddy service	MCEBuddy GUI: Không thể dừng dịch vụ MCEBuddy
MCEBuddy GUI: Unable to cancel job	MCEBuddy GUI: Không thể hủy bỏ công việc
Warning: Networked files will be accessed using the logon credentials of the MCEBuddy Service, not the currently logged on user. You can manually specify the network credentials from the Settings -> Expert Settings page in MCEBuddy.	Cảnh báo: Quản lý tập tin sẽ được truy cập bằng cách sử dụng ủy nhiệm đăng nhập dịch vụ MCEBuddy, không phải là người dùng hiện thời đã đăng nhập. Bạn có thể chỉ định thủ công thông tin đăng nhập mạng từ các cài đặt-> trang cài đặt chuyên gia ở MCEBuddy.
Credential Warning	Cảnh báo ủy nhiệm
Status	Tình trạng
MCEBuddy GUI: Unable to add job	MCEBuddy GUI: Không thể thêm công việc
MCEBuddy GUI: Unable to get pipe active status	MCEBuddy GUI: Không thể lấy ống tình trạng hoạt động
The conversions must be stopped to change settings. Stop the conversions?	Các chuyển đổi phải được ngừng lại để thay đổi cài đặt. Ngăn chặn các chuyển đổi?
Stop Engine	Ngừng động cơ
MCEBuddy GUI: Unable to stop MCEBuddy service from settings click	MCEBuddy GUI: Không thể dừng dịch vụ MCEBuddy từ nhấp chuột cài đặt
MCEBuddy GUI: Unable to rescan files	MCEBuddy GUI: Không thể rescan tập tin
MCEBuddy GUI: Unable to open link	MCEBuddy GUI: Không thể mở liên kết
Close	Đóng
Close this window, MCEBuddy will keep running in the background	Đóng cửa sổ này, MCEBuddy sẽ tiếp tục chạy dưới nền
If you like MCEBuddy, please click here to Donate - THANKS	Nếu bạn thích MCEBuddy, xin bấm vào đây để hiến tặng - cảm ơn
Click here to like MCEBuddy on facebook	Click vào đây để thích MCEBuddy trên facebook
Click here to open MCEBuddy website	Click vào đây để mở trang web MCEBuddy
Rescan	Rescan
Forces the MCEBuddy to recheck the Monitor locations for new video files to convert	Lực lượng MCEBuddy để kiểm tra lại địa điểm màn hình cho các file video mới để chuyển đổi
Monitor locations	Vị trí màn hình
Settings	Thiết đặt
Select the file(s) in the queue to delete	Chọn (các) tệp trong hàng đợi để xóa
Manually add video file(s) to the queue to convert	Tự thêm (các) tệp video để xếp hàng để chuyển đổi
Start the MCEBuddy monitor and conversion tasks	Bắt đầu MCEBuddy màn hình và chuyển đổi công việc
Stop the MCEBuddy monitor and conversion tasks	Ngừng MCEBuddy màn hình và chuyển đổi công việc
There is a new version!	Không có một phiên bản mới!
High	Cao
Low	Low
Priority	Ưu tiên
High priority - convert faster but may make other running applications unresponsive\r\nLow priority - convert in the background but reduced interference with other running applications	Ưu tiên cao - chuyển đổi nhanh hơn nhưng có thể làm cho các ứng dụng khác đang chạy unresponsive\r\nLow ưu tiên - chuyển đổi trong nền nhưng giảm can thiệp với các ứng dụng khác đang chạy
A task is a conversion template that contains a conversion profile and various other conversion parameters.\r\nEach file added to the queue will be processed and converted by each of these tasks.\r\nRefer to the MCEBuddy Guide for more details on how tasks work.	Một nhiệm vụ là một chuyển đổi mẫu đó có một hồ sơ chuyển đổi và nhiều khác parameters.\r\nEach chuyển đổi tập tin được thêm vào xếp hàng sẽ được xử lý và chuyển đổi của mỗi người trong số tasks.\r\nRefer hướng dẫn MCEBuddy để biết chi tiết về cách làm việc của công việc.
Getting started	Bắt đầu
Click here for MCEBuddy guide	Bấm vào đây để hướng dẫn MCEBuddy
Logs	Các bản ghi
Click to open log folder	Nhấn vào đây để mở thư mục đăng nhập
MCEBuddy Status	Tình trạng MCEBuddy
add	thêm
delete	xóa bỏ
paypal-donate	Paypal-tặng
stop	Dừng
OUTPUT: ConsoleOuput received NULL data	RA: ConsoleOuput nhận được dữ liệu NULL
hours	giờ
minutes	phút
second	Thứ hai
seconds	giây
Starting	Bắt đầu
Comskip advertisement scan - Pass 1	Comskip quảng cáo quét - vượt qua 1
Comskip advertisement scan - Pass 2	Comskip quảng cáo quét - vượt qua 2
Cutting commercials from video	Cắt thương mại từ video
Cutting commercials from video - segment 	Quảng cáo thương mại cắt từ video - phân đoạn 
Merging commercial free segments into new video	Việc sáp nhập thương mại miễn phí các phân đoạn vào video mới
Moving converted file to destination	Di chuyển tập tin chuyển đổi đến điểm đến
Checking for disk space	Kiểm tra dung lượng đĩa
Getting show information and banner from Internet sources	Nhận được thông tin hiển thị và biểu ngữ từ nguồn Internet
Copying source file to working directory	Sao nguồn tập tin vào thư mục làm việc
Remuxing recording	Remuxing ghi âm
ShowAnalyzer advertisement scan	ShowAnalyzer quảng cáo quét
Comskip advertisement scan	Comskip quảng cáo quét
Analyzing video information	Phân tích thông tin video
Converting	Chuyển đổi
Removing commercials	Loại bỏ quảng cáo thương mại
Writing show information	Văn bản hiển thị thông tin
Renaming file using show information	Đổi tên tệp bằng cách sử dụng hiển thị thông tin
Success - All done!	Thành công - tất cả được thực hiện!
Muxing streams	Muxing dòng
Fallback remux	Dự phòng remux
Correcting audio delay	Điều chỉnh âm thanh chậm trễ
Converting video file - Pass 1	Chuyển đổi tệp video - vượt qua 1
Converting video file - Pass 2	Chuyển đổi tệp video - vượt qua 2
Converting video file	Chuyển đổi tệp video
Audio Track	Rãnh âm thanh
Impaired	Khiếm thị
Channels	Các kênh
Codec	Codec
Video	Video
Duration	Thời gian
Height	Chiều cao
Width	Chiều rộng
Audio	Âm thanh
Name	Tên
Subtitle	Phụ đề
Volume	Khối lượng
Enable custom file renaming	Cho phép đổi tên tập tin tùy chỉnh
Enable this to enter a custom pattern to rename converted files and folders. Enter the custom pattern in the box below.\r\n\r\nExample:\r\nTVShows\%showname%\Season %season%\%showname% - S%season%##E%episode%## - %episodename% - %airyear%_%airmonth%_%airday%\r\n\r\nWill produce:\r\nTVShows\CSI\Season 1\CSI - S01E02 - Best of times - 2012_01_06.<ext>\r\n\r\nExample:\r\nRecording\%ismovie%<Movie\%showname%,TVShows\%showname%\Season %season%\%showname% - S%season%##E%episode%##>-Converted\r\n\r\nWill produce (for a movie)\r\n    Recording\Movies\Star Wars-Converted.<ext>\r\nOR (for non movies)\r\n    Recording\TVShows\CSI\Season 1\CSI - S01E02-Converted.<ext>\r\n\r\nRefer to the MCEBuddy advanced documentation for a list of all the pattern commands.	Cho phép này để nhập một mô hình tùy chỉnh để đổi tên chuyển đổi tập tin và thư mục. Nhập các mô hình tùy chỉnh trong hộp below.\r\n\r\nExample:\r\nTVShows\%showname%\Season %season%\%showname% - S % mùa % ##E % tập % ##-% episodename % - %airyear%_%airmonth%_%airday%\r\n\r\nWill sản xuất: \r\nTVShows\CSI\Season 1\CSI - S01E02 - tốt nhất của thời gian - 2012_01_06.<ext>\r\n\r\nExample:\r\nRecording\%ismovie% < Movie\%showname%,TVShows\%showname%\Season %season%\%showname% - S%season%##E%episode%##>-Converted\r\n\r\nWill sản xuất (cho một bộ phim) \r\n Recording\Movies\Star chuyển đổi Wars. <ext>\r\nOR (cho không phim) \r\n Recording\TVShows\CSI\Season 1\CSI - S01E02 chuyển đổi.<ext>\r\n\r\nRefer để MCEBuddy nâng cao tài liệu hướng dẫn để có danh sách của tất cả các lệnh mô hình.
ShowAnalyzer not found.\nPlease download and install ShowAnalyzer.	ShowAnalyzer không tìm thấy. \nPlease tải về và cài đặt ShowAnalyzer.
ShowAnalyzer Missing	ShowAnalyzer mất tích
Invalid language code, reverting to <Default> language	Mã ngôn ngữ không hợp lệ, quay trở lại <Default>ngôn ngữ
Cut start	Cắt bắt đầu
Cut end	Cắt kết thúc
This specifies the number of seconds to cut from the start of the recording (BEFORE removing the ads)	Điều này chỉ định số giây để cắt từ bắt đầu ghi âm (trước khi loại bỏ các quảng cáo)
This specifies the number of seconds to cut from the end of the recording (BEFORE removing the ads)	Điều này chỉ định số giây để cắt từ khi kết thúc ghi âm (trước khi loại bỏ các quảng cáo)
Send an eMail after each conversion.	Gửi một eMail sau mỗi chuyển đổi.
Send eMail	Gửi eMail
SMTP Server Name	Tên máy chủ SMTP
Enter the outgoing eMail (SMTP) server address here\r\ne.g. smtp.gmail.com	Nhập vào hệ phục vụ thư điện tử (SMTP) thư đi địa chỉ here\r\ne.g. SMTP.Gmail.com
Port	Cảng
Enter the SMTP server port	Nhập vào cổng máy chủ SMTP
Use SSL	Sử dụng SSL
Check this if you SMTP server uses SSL	Kiểm tra này nếu bạn SMTP server sử dụng SSL
e-Mail Settings	cài đặt e-Mail
From <e-Mail>	Từ <e-Mail>
Enter the senders (From) eMail address here	Nhập các người gửi này (từ) địa chỉ eMail dưới đây
To <e-Mails>	Để <e-Mails>
Enter the recipients (To) eMail address here.\r\nSeparate multiple recipients with a semicolon (;)	Nhập người nhận (để) eMail địa chỉ here.\r\nSeparate cho nhiều người nhận với một dấu chấm phẩy (;)
Send eMail on successful conversion	Gửi thư điện tử về chuyển đổi thành công
Send eMail on failed conversion	Gửi thư điện tử về chuyển đổi không thành công
Send eMail on cancelled conversion	Gửi thư điện tử về chuyển đổi hủy bỏ
Send eMail on adding a conversion to the queue	Gửi eMail về việc thêm một chuyển đổi sang hàng đợi
Please enter a valid server address	Vui lòng nhập một địa chỉ hệ phục vụ hợp lệ
Invalid SMTP Server	Hệ phục vụ SMTP không hợp lệ
Please enter a valid server port	Hãy đưa vào một cổng hệ phục vụ hợp lệ
Invalid SMTP Port	Cổng SMTP không hợp lệ
Please enter a valid From eMail address	Vui lòng nhập một hợp lệ từ địa chỉ eMail
Invalid eMail Address	Địa chỉ eMail không hợp lệ
Please enter valid To eMail addresses	Vui lòng nhập hợp lệ địa chỉ eMail
Username	Tên người dùng
<Optional> Enter the username for the eMail server authentication	<Optional>Enter tên người dùng cho xác thực máy chủ thư điện tử
<Optional> Enter the password for the eMail server authentication	<Optional>Enter mật khẩu cho việc xác thực hệ phục vụ thư điện tử
MCEBuddy unable to download series information	MCEBuddy không thể tải về hàng loạt thông tin
MCEBuddy successfully converted a video	MCEBuddy thành công chuyển đổi một video
Source Video	Nguồn Video
Converted Video	Video chuyển đổi
Converted At	Chuyển đổi tại
MCEBuddy failed to converted a video	MCEBuddy thất bại trong việc chuyển đổi một video
Failed At	Thất bại tại
MCEBuddy cancelled a video conversion	MCEBuddy hủy bỏ một chuyển đổi video
Cancelled At	Hủy bỏ tại
Working	Làm việc
Test	Thử nghiệm
Testing	Thử nghiệm
Click this button to test the eMail server settings	Bấm nút này để kiểm tra cài đặt máy chủ thư điện tử
MCEBuddy will send an eMail to test the server settings.\r\nThis can take upto 60 seconds.\r\nMCEBuddy may be unresponsive during this period.	MCEBuddy sẽ gửi một eMail để kiểm tra máy chủ settings.\r\nThis có thể mất tối đa 60 seconds.\r\nMCEBuddy có thể không phản hồi trong thời gian này.
Test eMail	Kiểm tra thư điện tử
MCEBuddy Test eMail	MCEBuddy Test thư điện tử
MCEBuddy - Have a great day!	MCEBuddy - có một ngày tuyệt vời!
Send eMail test successful	Gửi thư điện tử thử nghiệm thành công
Send eMail test failed! Please check your settings and internet connectivity	Gửi thư điện tử thử nghiệm thất bại! Vui lòng kiểm tra thiết đặt và kết nối internet của bạn
Test eMail Success	Kiểm tra eMail thành công
Test eMail Failed	Kiểm tra eMail Failed
Send eMail on start of conversion	Gửi eMail khởi động của chuyển đổi
MCEBuddy started a video conversion	MCEBuddy bắt đầu một chuyển đổi video
Conversion Started At	Chuyển đổi bắt đầu lúc
Yes (Comskip)	Có (Comskip)
Yes (ShowAnalyzer)	Có (ShowAnalyzer)
Atleast one Conversion Task must be enabled	Atleast một chuyển đổi nhiệm vụ phải được bật
Disable	Vô hiệu hoá
Enable	Cho phép
Rename	Đổi tên
Move	Di chuyển
Up	Lên
Down	Xuống
Slow Remuxing	Remuxing chậm
Extracting closed captions	Chiết xuất phụ đề đóng
Validating closed captions	Phê chuẩn phụ đề đóng
Extracting subtitles	Chiết xuất phụ đề
Trimming closed captions	Chú thích trang trí đóng cửa
Extract subtitles and closed captions	Trích xuất phụ đề và phụ đề đóng
Field	Lĩnh vực
Channel	Kênh
Enable this to extract Closed Captions, Subtitles and Teletext from\r\nWTV, DVR-MS, TS, MP4, MKV and other supported files.\r\n\r\nIt is saved as a Subtitle (SRT) file.	Kích hoạt này để giải nén đóng cửa phụ đề, phụ đề và Teletext from\r\nWTV, DVR-MS, TS, MP4, MKV và khác files.\r\n\r\nIt được hỗ trợ được lưu dưới dạng tệp phụ đề (SRT).
Enable this to set advanced options for Closed Captions extraction\r\nField - 1 or 2\r\nChannel - 1 or 2\r\n\r\nDefault: Field 1, Channel 1	Kích hoạt tính năng này để đặt tùy chọn chuyên sâu cho phụ đề đóng cửa extraction\r\nField - 1 hay 2\r\nChannel - 1 hoặc 2\r\n\r\nDefault: lĩnh vực 1, kênh 1
Subtitle offset	Phụ đề bù đắp
Enter the number of seconds (+ve / -ve) to adjust the subtitles sync with video	Nhập số giây (+ ve / - ve) để điều chỉnh đồng bộ phụ đề với video
Re-ReMuxing due to audio error	Re-ReMuxing nhờ âm thanh lỗi
Save the poster and show information (metadata) in a MC/XBMC compatible NFO file (XML format)	Tiết kiệm các áp phích và hiển thị thông tin (siêu dữ liệu) trong một MC/XBMC tương thích NFO file (định dạng XML)
Check this box to save the show information (metadata) in the converted file.\r\nThis only works for files that support metadata tags like MP4, MKV, WTV etc.\r\n\r\nNOTE: Uncheck this box if you're facing issues with some devices such as older TV's which have problem reading metadata.	Kiểm tra hộp này để lưu thông tin hiển thị (siêu dữ liệu) trong chuyển đổi file.\r\nThis chỉ làm việc cho các tập tin hỗ trợ thẻ siêu dữ liệu như MP4, MKV, WTV etc.\r\n\r\nNOTE: bỏ chọn ô này nếu bạn đang phải đối mặt với vấn đề với một số thiết bị như của TV cũ có vấn đề đọc siêu dữ liệu.
Atleast one day of the week must be enabled	Atleast một ngày trong tuần phải được bật
Invalid Days of Week	Không hợp lệ ngày của tuần
Invalid day of week found in configuration file	Ngày không hợp lệ trong tuần được tìm thấy trong tập tin cấu hình
Scheduling	Lập kế hoạch
Remuxing to	Remuxing để
Part	Một phần
Rest your mouse on any button, box or item to get Instant Help on it.\n\nFor more information on how to use, troubleshoot or get support for MCEBuddy click on the <Getting Started> link on the top right corner.\n\nDonations are always welcome :) Enjoy!\n\n  - Ramit, Derek & Goose	Còn lại con chuột của bạn trên bất kỳ nút, hộp hoặc các mặt hàng để có được trợ giúp ngay lập tức trên it.\n\nFor thêm thông tin về làm thế nào để sử dụng, khắc phục sự cố hoặc có được hỗ trợ cho MCEBuddy nhấp vào liên kết < Bắt Đầu > trên bên phải corner.\n\nDonations hàng đầu là luôn luôn chào mừng bạn đến :) Tận hưởng! \n\n - Ramit, Derek & ngỗng
Welcome to MCEBuddy	Chào mừng đến với MCEBuddy
Multichannel audio	Âm thanh Multichannel
Check to allow multi-channel audio if the source video supports it.\r\nBy default the audio is limited to 2 channels (stereo).	Kiểm tra để cho phép đa kênh âm thanh nếu nguồn video hỗ trợ it.\r\nBy mặc định âm thanh được giới hạn 2 kênh (stereo).
Dynamic Range Compression (DRC)\r\nWhen the source is an AC3 audio, enabling DRC will\r\nreduce the difference between the loud and the soft\r\nsounds making the audio track more even.\r\nIf you have a multi-channel audio recording and you\r\nfeel the volume is too soft, checking this box might help.	Dynamic Range nén (DRC) \r\nWhen nguồn là một âm thanh AC3, cho phép DRC will\r\nreduce sự khác biệt giữa các lớn và soft\r\nsounds làm cho theo dõi âm thanh thêm even.\r\nIf bạn có một ghi âm thanh đa kênh và you\r\nfeel là quá mềm, kiểm tra hộp này có thể giúp đỡ.
FPS	KHUNG HÌNH/GIÂY
Logfile age (days)	Logfile tuổi (ngày)
Maximum number of days to keep the logfiles before deleting them.\r\nSet to 0 to keep the logs forever.	Số lượng tối đa của ngày để giữ cho các tập tin ghi lưu trước khi xóa them.\r\nSet 0 để giữ các bản ghi mãi mãi.
DVRMS Remuxing	DVRMS Remuxing
Fast Remuxing	Nhanh Remuxing
Byte stream remuxing	Byte dòng remuxing
Disable cropping	Vô hiệu hóa cắt xén
Check this to disable cropping the video automatically during conversion.\r\nCropping is used to remove the "black bars" in the video (top, bottom, left or right).\r\nUse this option if the video picture is getting cut on any side or if the final picture is looking stretched or distorted.	Kiểm tra này để vô hiệu hóa cắt xén video tự động trong conversion.\r\nCropping được sử dụng để loại bỏ các quán bar"đen" trong đoạn video (đỉnh, đáy, trái hoặc right).\r\nUse tùy chọn này nếu hình ảnh video nhận được cắt bên nào hoặc nếu những hình ảnh cuối cùng tìm được kéo dài hoặc bị méo.
Only detect Ads	Chỉ phát hiện quảng cáo
Check this if you want MCEBuddy to detect the ads (commercials) but NOT cut them from the video.\r\nWhen this option is enabled, MCEBuddy will create an EDL file along with the converted file that specifies the locations of ads in the converted video.\r\nAlso, for MP4, M4V and MKV files MCEBuddy will create Chapters to mark the end of commercials.	Kiểm tra này nếu bạn muốn MCEBuddy để phát hiện các quảng cáo (quảng cáo) nhưng không cắt chúng từ video.\r\nWhen tùy chọn này được kích hoạt, MCEBuddy sẽ tạo ra một tập tin EDL cùng với các tập tin chuyển đổi chỉ định vị trí của quảng cáo trong video.\r\nAlso chuyển đổi, cho MP4, M4V và MKV tập tin MCEBuddy sẽ tạo chương để đánh dấu sự kết thúc của thương mại.
Download information	Tải thông tin
Correction	Chỉnh sửa
Click here to correct the Show title and force use of a specific TVDB series id or IMDB movie id\r\nto lookup additional metadata from the internet.	Click vào đây để sửa tên hiển thị và lực lượng sử dụng của một cụ thể TVDB loạt id hoặc IMDB id\r\nto phim tra cứu siêu dữ liệu bổ sung từ internet.
Check this to download additional information from the internet about the show like a banner file, episode, season etc	Kiểm tra này để tải về thông tin bổ sung từ internet về hiển thị như một tập tin biểu ngữ, tập, mùa vv
Profile Error	Hồ sơ lỗi
Cannot find selected profile in profiles.conf	Không thể tìm thấy hồ sơ đã chọn trong profiles.conf
Invalid Profile	Hồ sơ không hợp lệ
Please select a valid profile	Vui lòng chọn một hồ sơ hợp lệ
The MCEBuddy Engine has crashed. Please send mcebuddy.log to the developers	Các công cụ MCEBuddy đã rơi. Xin vui lòng gửi mcebuddy.log để các nhà phát triển
Comskip INI	Comskip này
Select the custom Comskip INI file to use for this conversion task\r\nLeave this blank to use the default Comskip INI file for advertisement removal	Chọn tập tin Comskip này tùy chỉnh để sử dụng cho task\r\nLeave chuyển đổi này trống này sử dụng mặc định các tập tin Comskip này để loại bỏ quảng cáo
Click to select custom Comskip INI file	Nhấn vào đây để chọn tập tin Comskip này tùy chỉnh
Select the folder for working with temporary files. Make sure there is enough empty space on the drive.\r\nLeave this blank to use the default temp folder in the installation folder.	Chọn cặp để làm việc với tệp tạm thời. Chắc chắn có sản phẩm nào đủ space vào drive.\r\nLeave này trống để sử dụng thư mục tạm mặc định trong thư mục cài đặt.
Select the folder for working with temporary files. Make sure there is enough empty space on the drive.\r\nThis overrides the temp folder specified in the Settings -> Expert Settings page.	Chọn thư mục để làm việc với tệp tạm thời. Đảm bảo rằng có đủ không gian trống trên drive.\r\nThis sẽ thay thế thư mục tạm được chỉ định trong cài đặt-> trang cài đặt chuyên gia.
Click to select temp working folder	Nhấn vào đây để chọn temp thư mục làm việc
Temp folder	Thư mục tạm thời
Space check	Phòng Space
When enabled MCEBuddy will check for enough free space for the conversion (destination and temp).\r\nUncheck this if you have are having trouble with network drives or have extraordinarily large video files.	Khi kích hoạt MCEBuddy sẽ kiểm tra đủ không gian trống cho chuyển đổi (điểm đến và temp).\r\nUncheck điều này nếu bạn có là có rắc rối với ổ đĩa mạng hoặc có tập tin video lớn bất thường.
MCEBuddy Windows Event Logs	MCEBuddy Windows bản ghi sự kiện
Events	Sự kiện
Click here to open the MCEBuddy Windows Event Logs	Click vào đây để mở bản ghi sự kiện Windows MCEBuddy
Enable UPnP	Sử UPnP
Check this to enable UPnP. This allows access to MCEBuddy engine from outside the network.\r\nThis needs to be checked if you're using a mobile/standalone MCEBuddy client to access MCEBuddy.	Kiểm tra này để cho phép UPnP. Điều này cho phép truy cập vào MCEBuddy động cơ từ bên ngoài network.\r\nThis phải được kiểm tra nếu bạn đang sử dụng một điện thoại di động/độc lập MCEBuddy khách hàng để truy cập vào MCEBuddy.
Click here to connect to another MCEBuddy engine	Click vào đây để kết nối với một động cơ MCEBuddy
MCEBuddy Remote Engine Connection	Kết nối từ xa MCEBuddy động cơ
Engine Name	Động cơ tên
Engine Port	Động cơ Port
Enter the Name or IP Address of the MCEBuddy engine you want to connect to	Nhập tên hoặc địa chỉ IP của động cơ MCEBuddy bạn muốn kết nối tới
Enter the TCP Port number of the MCEBuddy Engine you want to connect to	Nhập số cổng TCP động MCEBuddy mà bạn muốn kết nối tới
Enter the TCP Port number of the MCEBuddy Engine you want to connect to (1 to 63355)	Nhập số cổng TCP động MCEBuddy mà bạn muốn kết nối tới (1 để 63355)
Invalid Name/Port	Tên/cổng không hợp lệ
Please enter a valid Engine Name and Engine Port Number	Vui lòng nhập một động cơ tên hợp lệ và động cơ số hiệu cổng
Error Stopping Engine	Lỗi dừng lại động cơ
Unable to stop MCEBuddy engine, settings may not be saved. Do you want to continue?	Không thể để ngăn chặn các động cơ MCEBuddy, cài đặt có thể không được lưu. Bạn có muốn tiếp tục?
Unable to communicate with engine. Settings have NOT been saved.	Không thể giao tiếp với động cơ. Cài đặt đã không được lưu.
Communication Error	Lỗi giao tiếp
Engine not stopped. Settings have NOT been saved.	Động cơ không ngừng. Cài đặt đã không được lưu.
Unable To Save Settings	Không thể lưu thiết đặt
Unable to communicate with engine. UPnP settings have not been updated	Không thể giao tiếp với động cơ. UPnP cài đặt đã không được Cập Nhật
Audio delay	Âm thanh chậm trễ
Enter a value in seconds (positive or negative) here to shift the audio relative to the video.\r\nUse this to resync the audio with the video, if they are out of sync after conversion.\r\nA positive value will delay the audio (i.e. video ahead of audio) and a negative value will advanced the audio (i.e. audio ahead of video).\r\nE.g. -1.5	Nhập giá trị trong vài giây (tích cực hay tiêu cực) ở đây để thay đổi âm thanh tương đối so với video.\r\nUse này resync âm thanh với video, nếu họ được ra khỏi đồng bộ sau khi conversion.\r\nA giá trị tích cực sẽ trì hoãn âm thanh (tức là video trước của âm thanh) và một giá trị tiêu cực sẽ nâng cao âm thanh (tức là âm thanh trước video).\r\nE.g. -1,5
Media info	Thông tin phương tiện
Click here to get media properties for selected files	Click vào đây để có được phương tiện truyền thông thuộc tính cho tệp đã chọn
Save information	Lưu thông tin
Add information	Thêm thông tin
Shows a preview of the custom filename and path	Cho thấy một bản xem trước của các tùy chỉnh tên tệp và đường dẫn
Invalid Filename Pattern	Mô hình Tên tệp không hợp lệ
TVDB Series ID	TVDB loạt các ID
IMDB Series ID	IMDB loạt ID
Original title	Original tiêu đề
Corrected title	Sửa chữa các tiêu đề
Enter the TVDB Series ID you want to use for downloading show information.\r\nIf the Original title box is empty, this will be applied to all shows selected by this conversion task.	Nhập ID loạt TVDB bạn muốn sử dụng để tải về hiển thị information.\r\nIf hộp tiêu đề ban đầu là sản phẩm nào, điều này sẽ được áp dụng cho tất cả cho thấy được lựa chọn bởi công việc chuyển đổi này.
Enter the IMDB Movie ID you want to use for downloading movie information.\r\nIf the Original title box is empty, this will be applied to all shows selected by this conversion task.	Nhập ID IMDB phim bạn muốn sử dụng để tải về bộ phim information.\r\nIf trữ tiêu đề hộp là sản phẩm nào, điều này sẽ được áp dụng cho tất cả cho thấy được lựa chọn bởi công việc chuyển đổi này.
Internet Lookup Title and Metadata Correction	Internet tìm kiếm tiêu đề và siêu dữ liệu sửa chữa
Click here to add another row to match and correct titles and series id.\r\nIf you want to use the same corrected title or series id for all shows converted by this conversion task,\r\nleave the original title blank on the first row and you should NOT add a second row.	Click vào đây để thêm một hàng để phù hợp và đúng tiêu đề và loạt id.\r\nIf bạn muốn sử dụng cùng một tiêu đề sửa chữa hoặc loạt id cho tất cả cho thấy chuyển đổi của các nhiệm vụ chuyển đổi này, \r\nleave chỗ trống tiêu đề ban đầu vào ngày đầu tiên hàng và bạn không nên thêm từ một hàng thứ hai.
Enter pattern to match show/series titles for correction (e.g. Simpson* will replace all titles that have a show title starting with Simpson)\r\nPrefix pattern with ~ to skip the match (e.g. *.*;~Simpson* will correct all show titles except those that start with Simpson)\r\nSeparate multiple patterns with ; (e.g. Simpson*;House*) or (e.g. Simpson*;NCIS*;~NCIS Miami*)\r\n\r\nNOTE: Leave this box empty if you want to apply the corrected title or series id to ALL files being processed by this conversion task.\r\nIf leaving blank, you cannot add a second row.\r\n\r\nYou can use a regular expression to match the title by starting with regex:	Nhập các mô hình để phù hợp với Hiển thị/series tiêu đề cho chỉnh sửa (ví dụ như Simpson * sẽ thay thế tất cả các tiêu đề có một tiêu đề Hiển thị bắt đầu với Simpson) \r\nPrefix mô hình với ~ để bỏ qua các trận đấu (ví dụ: *. *; ~ Simpson * sẽ sửa chữa tất cả Hiển thị tiêu đề ngoại trừ những người bắt đầu với Simpson) \r\nSeparate nhiều mô hình với; (ví dụ như Simpson *;House*) hoặc (ví dụ như Simpson *;NCIS*; ~ NCIS Miami *) \r\n\r\nNOTE: để trống nếu bạn muốn áp dụng các tiêu đề chính xác hoặc loạt id cho tất cả các tập tin được xử lý bởi task.\r\nIf chuyển đổi này để lại trống, bạn không thể thêm một row.\r\n\r\nYou thứ hai có thể sử dụng một biểu thức chính quy để phù hợp với tiêu đề bằng cách bắt đầu với regex hộp này:
Enter the new/corrected title you want to use for downloading additional information from the internet.\r\nIf the Original title box is empty, this will be applied to all shows selected by this conversion task.\r\n\r\nYou can use a regular expression to correct the title by starting with regex:	Nhập tiêu đề mới/sửa chữa bạn muốn sử dụng để tải về thông tin bổ sung từ internet.\r\nIf trữ tiêu đề hộp là sản phẩm nào, điều này sẽ được áp dụng cho tất cả cho thấy được lựa chọn bởi chuyển đổi này task.\r\n\r\nYou có thể sử dụng một biểu thức chính quy để sửa tiêu đề bằng cách bắt đầu với regex:
For each row, please enter the Original title to match the show name AND either a Corrected title or a TVDB/IMDB Series ID	Đối với mỗi hàng, vui lòng nhập tên gốc để phù hợp với tên hiển thị và một trong hai Corrected một tiêu đề hoặc một ID loạt TVDB/IMDB
Please enter either a Corrected title or a TVDB/IMDB Series ID	Vui lòng nhập một tiêu đề Corrected hoặc một ID loạt TVDB/IMDB
Enable this if you want MCEBuddy to put the converted file in the source directory\r\nif the destination path is unavailable. (e.g. Network failure or mapping failure)	Kích hoạt này nếu bạn muốn MCEBuddy để đặt các chuyển đổi tập tin trong nguồn directory\r\nif đường dẫn đích không có sẵn. (ví dụ như mạng thất bại hay thất bại lập bản đồ)
Fallback to source path	Dự phòng để đường dẫn nguồn
Used to increase or decrease the volume of the\r\nrecording while converting.\r\n1 is normal, anything below will reduce it, anything\r\nhigher will increase it.	Được sử dụng để tăng hoặc giảm âm lượng của the\r\nrecording trong khi converting.\r\n1 là bình thường, bất cứ điều gì dưới đây sẽ làm giảm nó, anything\r\nhigher sẽ tăng nó.
Archive folder	Thư mục lưu trữ
Change the location of the archive folder.\r\nLeave empty to use the default 'MCEBuddyArchive' folder in the original directory.	Thay đổi vị trí lưu trữ folder.\r\nLeave sản phẩm nào để sử dụng thư mục 'MCEBuddyArchive' mặc định trong thư mục gốc.
Monitor subdirectories	Màn hình thư mục con
Check this box to also monitor all directories within the Monitor path	Kiểm tra hộp này cũng có thể theo dõi tất cả các thư mục trong con đường của màn hình
Click here to show MCEBuddy status	Click vào đây để hiển thị tình trạng MCEBuddy
MCEBuddy service not connected	MCEBuddy dịch vụ không được kết nối
MCEBuddy idle	MCEBuddy nhàn rỗi
conversions in progress	chuyển đổi trong tiến trình
MCEBuddy stopped	MCEBuddy dừng lại
Sync converted files	Đồng bộ hóa tập tin chuyển đổi
Check this option if you want MCEBuddy to keep the converted files in sync with the original files.\r\ni.e. When the original files are deleted by the user, the corresponding converted files are also deleted.\r\n\r\nNOTE: MCEBuddy only monitors original files in the monitor locations folders and ONLY while the engine is running.\r\nMCEBuddy will not be able to track user deleted files while the engine is stopped.	Chọn tùy chọn này nếu bạn muốn MCEBuddy để giữ cho các tập tin chuyển đổi đồng bộ với bản gốc files.\r\ni.e. Khi các tập tin ban đầu được xóa bỏ bởi người dùng, các tập tin chuyển đổi tương ứng cũng là deleted.\r\n\r\nNOTE: MCEBuddy chỉ theo dõi các tập tin ban đầu trong các thư mục địa điểm theo dõi và chỉ trong khi động cơ running.\r\nMCEBuddy sẽ không thể theo dõi người dùng xóa các tập tin trong khi động cơ được dừng lại.
Do you wish MCEBuddy to delete each converted file when the original file has been deleted?	Bạn có muốn MCEBuddy để xóa tập tin chuyển đổi mỗi khi các tập tin ban đầu đã bị xóa?
Confirm sync conversions?	Xác nhận đồng bộ chuyển đổi?
Are you sure you DO NOT want to remove commercials from the converted video and only keep the EDL file?	Bạn có chắc chắn bạn không muốn để loại bỏ quảng cáo từ video chuyển đổi và chỉ giữ lại các tập tin EDL?
ShowAnalyzer is not responding. Please the reboot system or reinstall ShowAnalyzer.	ShowAnalyzer không đáp ứng. Xin vui lòng khởi động lại hệ thống hoặc cài đặt lại ShowAnalyzer.
ShowAnalyzer Not Responding	ShowAnalyzer không đáp ứng
Make sure you press 'Start' after closing this window, otherwise Scheduling and Wake will not work.	Hãy chắc chắn rằng bạn bấm 'Bắt đầu' sau khi đóng cửa sổ này, nếu không lập kế hoạch và đánh thức sẽ không làm việc.
Enabling Scheduling and Wake	Cho phép lập lịch trình và trỗi dậy
Passwords do not match	Mật khẩu không khớp
Password error	Mật khẩu lỗi
Adding subtitles and chapters to file	Thêm phụ đề và chương để tập tin
Send eMail if unable to download series information	Gửi eMail nếu không thể tải về hàng loạt thông tin
Check this box if you want this conversion task to only process files from specific monitor locations.\r\nIf unchecked each conversion task will process files from all monitor locations (including new ones added later).	Kiểm tra hộp này nếu bạn muốn công việc chuyển đổi này để chỉ xử lý các tập tin từ màn hình cụ thể locations.\r\nIf đánh dấu mỗi công việc chuyển đổi sẽ xử lý các tập tin từ tất cả các địa điểm màn hình (bao gồm cả những cái mới được thêm vào sau này).
Select Monitor Locations	Màn hình chọn địa điểm
Select atleast one Monitor Location name	Chọn ít nhất một trong những vị trí màn hình Tên
You have selected all the current Monitor Locations.\r\nDo you want this conversion task to automatically process any new Monitor Locations added in future?	Bạn đã chọn tất cả các hiện tại màn hình Locations.\r\nDo bạn muốn tác vụ chuyển đổi này để tự động xử lý bất kỳ vị trí màn hình mới được thêm vào trong tương lai?
New monitor locations	Địa điểm màn hình mới
Invalid selection	Lựa chọn không hợp lệ
Channel name match	Phù hợp với tên kênh
Enter pattern to match the channel name for this task (e.g. ABC* will convert all files that recorded on a channel name starting with ABC)\r\nPrefix pattern with ~ to skip the match (e.g. *;~ABC* will process all channels except those that start with ABC)\r\nSeparate multiple patterns with ; (e.g. ABC*;TBS*) or (e.g. ABC*;Fox*;~Fox4*)\r\n\r\nYou can use regular expressions to match the pattern by starting with regex:	Nhập các mô hình để phù hợp với tên kênh cho nhiệm vụ này (ví dụ: ABC * sẽ chuyển đổi tất cả các tập tin được ghi lại trên một kênh tên bắt đầu với ABC) \r\nPrefix mô hình với ~ để bỏ qua các trận đấu (ví dụ: *; ~ ABC * sẽ xử lý tất cả các kênh ngoại trừ những người bắt đầu với ABC) \r\nSeparate nhiều mô hình với; (ví dụ: ABC *;TBS*) hoặc (ví dụ: ABC *;Fox*; ~ Fox4 *) \r\n\r\nYou có thể sử dụng biểu thức thông thường để phù hợp với các mô hình bằng cách bắt đầu với regex:
Clear history	Xóa các Lược sử
Click this button to clear the history of all converted files.\r\nThis is cause MCEBuddy to reconvert all files being monitored.	Nhấp vào nút này để xóa lịch sử của tất cả chuyển đổi files.\r\nThis là gây ra MCEBuddy để reconvert tất cả các tệp đang được theo dõi.
Are you sure you want to clear the history of all conversions?\r\nThis will cause MCEBuddy to reconvert all files being monitored.	Bạn có chắc bạn muốn xóa lịch sử của tất cả các chuyển đổi? \r\nThis sẽ gây ra MCEBuddy để reconvert tất cả các tệp đang được theo dõi.
Show history	Hiển thị lịch sử
Click this button to show the history of all converted files.	Nhấp vào nút này để hiển thị lịch sử của tất cả các tập tin chuyển đổi.
History of Converted Files	Lịch sử của tập tin chuyển đổi
Unable to communicate with engine.	Không thể giao tiếp với động cơ.
Extracting streams	Giải nén dòng
Fallback muxing streams	Dự phòng muxing dòng
Remuxing TiVO file	Remuxing TiVO tập tin
Enter your 10 digit TiVO MAK key to convert and process TiVO recordings	Nhập chữ số 10 của bạn TiVO MAK phím để chuyển đổi và xử lý TiVO bản thu âm
Invalid TiVO MAK Key	Không hợp lệ TiVO MAK Key
The TiVO MAK key should be 10 digits	TiVO MAK phím nên là 10 chữ số
Version mismatch. Please ensure that the MCEBuddy client and engine are running the same version.	Phiên bản không phù hợp. Hãy đảm bảo rằng khách hàng MCEBuddy và động cơ đang chạy cùng một phiên bản.
Error retrieving Event Logs	Lỗi lấy bản ghi sự kiện
Unable to get Event Log Entries from the MCEBuddy engine.	Không thể để có được sự kiện đăng nhập mục từ động cơ MCEBuddy.
PAUSED: Check conversion schedule	Tạm dừng: Kiểm tra lịch trình chuyển đổi
Logging	Đăng nhập
Folder Management	Quản lý thư mục
Processor Management	Bộ vi xử lý quản lý
Expert Settings	Thiết đặt chuyên gia
System Settings	Thiết đặt hệ thống
Click here to change additional settings (for experts only)	Click vào đây để thay đổi các cài đặt bổ sung (dành cho các chuyên gia)
Failed folder	Thất bại thư mục
Location of the folder that hold the original files for failed conversions.	Vị trí của thư mục có chứa các tập tin ban đầu cho chuyển đổi thất bại.
Move original file on failure	Di chuyển các tập tin ban đầu về thất bại
Check this to move the original file to a separate folder if the conversion fails.	Kiểm tra này để di chuyển các tập tin ban đầu vào một thư mục riêng biệt nếu việc chuyển đổi không.
Check this to limit the number of logical processors that MCEBuddycan use.\r\nEach check box below corresponds to an available logical processor.	Kiểm tra này để giới hạn số lượng các bộ vi xử lý hợp lý MCEBuddycan use.\r\nEach hộp kiểm dưới đây tương ứng với một bộ xử lý hợp lý có sẵn.
Each box represents logical processors from 1 to 16 respectively.\r\nChecking a box allows MCEBuddy to use that processor.	Mỗi hộp đại diện cho hợp lý xử từ 1 đến 16 respectively.\r\nChecking một hộp cho phép MCEBuddy để sử dụng bộ vi xử lý đó.
Each box represents logical processors from 17 to 32 respectively.\r\nChecking a box allows MCEBuddy to use that processor.	Mỗi hộp đại diện cho hợp lý xử từ 17 đến 32 respectively.\r\nChecking một hộp cho phép MCEBuddy để sử dụng bộ vi xử lý đó.
Select atleast one processor to use	Chọn ít nhất một bộ xử lý sử dụng
Invalid Configuration	Cấu hình không hợp lệ
Comskip path	Đường dẫn Comskip
If you want to use a custom version of Comkip (e.g. donator version)\r\nthen enter the path of the comskip installation here.\r\nLeave blank to use the default comskip that comes with MCEBuddy.	Nếu bạn muốn sử dụng một phiên bản tùy chỉnh của Comkip (ví dụ như phiên bản donator) \r\nthen nhập đường dẫn comskip cài đặt here.\r\nLeave trống để sử dụng comskip mặc định mà đi kèm với MCEBuddy.
Miscellaneous	Linh tinh
Ignore copy protection	Bỏ qua bản sao bảo vệ
Check this to ignore the copy protection flag on video file while converting.\r\nNOTE: MCEBuddy cannot bypass encryption, this only helps if a file is incorrectly\r\ntagged as copy protected when it is NOT encrypted.	Kiểm tra này để bỏ qua bản sao bảo vệ lá cờ trên các tập tin video trong khi converting.\r\nNOTE: MCEBuddy không thể vượt qua mã hóa, điều này chỉ giúp nếu tập tin là incorrectly\r\ntagged như là bản sao bảo vệ khi nó không được mã hóa.
Use recycle bin	Sử dụng recycle bin
Check this to use the recycle bin when files are deleted by MCEBuddy	Kiểm tra này để dùng thùng rác khi tập tin sẽ bị xóa bởi MCEBuddy
Poll period	Giai đoạn thăm dò ý kiến
This is how often MCEBuddy scans the Monitor Tasks Locations for new files.\r\nThe interval is specified in seconds.	Điều này là làm thế nào thường MCEBuddy quét các vị trí công việc theo dõi cho mới files.\r\nThe khoảng thời gian được chỉ định trong vài giây.
Server port	Cổng máy chủ
This is the TCP port MCEBuddy uses to communicate with the remote engine.\r\nWhen UPnP is enabled, MCEBuddy will automatically add this port to the Windows Firewall\r\nand UPnP gateway to allow access from the internet on this port.	Đây là cổng TCP MCEBuddy sử dụng để giao tiếp với engine.\r\nWhen từ xa UPnP được kích hoạt, MCEBuddy sẽ tự động thêm cổng này là cửa ngõ Windows Firewall\r\nand UPnP để cho phép truy cập từ internet trên cổng này.
Hang period	Hang thời gian
Enter the number of seconds that MCEBuddy will wait for a response from the\r\nunderlying application before terminates the application as hung.\r\nEnter 0 to disable hang detection.	Nhập số giây mà MCEBuddy sẽ chờ đợi một phản ứng từ ứng dụng the\r\nunderlying trước khi chấm dứt các ứng dụng như hung.\r\nEnter 0 để vô hiệu hóa hàng phát hiện.
Subtitle commercial cut sync	Phụ đề thương mại cắt đồng bộ
This parameter is used when the subtitles go progressively out of sync after each commercial segment is removed from the video.\r\nThis setting is used to bring the subtitles back into sync with the video.\r\nEach time the video commercial is cut out, the subtitles are time shifted by this amount (+ve or -ve in seconds).	Tham số này được sử dụng khi phụ đề đi đồng dần dần ra bộ sau khi mỗi đoạn thương mại được lấy ra từ các thiết lập video.\r\nThis được sử dụng để mang lại cho phụ đề trở thành đồng bộ với thời gian video.\r\nEach video thương mại được cắt ra, phụ đề là thời gian chuyển bởi số tiền (+ ve hoặc này - ve trong giây).
Invalid poll period	Giai đoạn thăm dò ý kiến không hợp lệ
Invalid server port	Cổng máy chủ không hợp lệ
eMail Subject Customization	thư điện tử chủ đề tuỳ chỉnh
Use this section to customize the subject of eMail sent by MCEBuddy on the various conversion events listed below.\r\nRefer to the documentation, custom commands for user defined variables.\r\ne.g. Show %showname% for file %originalfilename% conversion successful using task %taskname%\r\nNOTE: Not always will all the data be available in the custom commands.\r\nLeave blank to use default subject lines.	Sử dụng phần này để tuỳ chỉnh các chủ đề của thư điện tử được gửi bởi MCEBuddy trên sự kiện chuyển đổi khác nhau liệt kê below.\r\nRefer để các tài liệu, tùy chỉnh lệnh cho người dùng xác định variables.\r\ne.g. Hiển thị showname % cho tệp % originalfilename % chuyển đổi thành công bằng cách sử dụng nhiệm vụ % taskname%\r\nNOTE: không phải luôn luôn sẽ tất cả các dữ liệu có sẵn trong commands.\r\nLeave tùy chỉnh trống để sử dụng dòng tiêu đề mặc định.
Success	Thành công
Failed	Thất bại
Cancelled	Hủy bỏ
Download fail	Tải về thất bại
Limit processor utilization	Giới hạn bộ vi xử lý sử dụng
Check this to limit the number of logical processors that MCEBuddy can use.\r\nEach check box below corresponds to an available logical processor.	Kiểm tra này để giới hạn số lượng các bộ vi xử lý hợp lý rằng MCEBuddy có thể use.\r\nEach hộp kiểm dưới đây tương ứng với một bộ xử lý hợp lý có sẵn.
Custom profile	Tùy chỉnh hồ sơ
If you have a custom profiles.conf file that you want to use instead of the\r\none that comes with MCEBuddy, enter the path to the file here.\r\n\r\nNOTE: MCEBuddy constantly updates profiles.conf to provide bug fixes,\r\nenhancements and performance improvements which you will miss out\r\non if you use this feature.	Nếu bạn có một tập tin profiles.conf tùy chỉnh mà bạn muốn sử dụng thay vì the\r\none mà đi kèm với MCEBuddy, nhập đường dẫn đến tập tin here.\r\n\r\nNOTE: MCEBuddy liên tục Cập Nhật profiles.conf để cung cấp cho lỗi sửa chữa, \r\nenhancements và hiệu suất cải tiến bạn sẽ bỏ lỡ out\r\non nếu bạn sử dụng tính năng này.
Invalid custom profiles.conf	Profiles.conf tùy chỉnh không hợp lệ
Suspend on battery	Đình chỉ trên pin
Suspend conversions when the computer switches to battery power	Đình chỉ chuyển đổi khi máy tính chuyển sang năng lượng pin
MCEBuddy added a video conversion to the queue	MCEBuddy thêm một chuyển đổi video để xếp hàng
Queue	Hàng đợi
Refer to documentation on using custom commands in custom eMail subjects	Tham khảo tài liệu hướng dẫn về cách sử dụng lệnh riêng trong đối tượng tùy chỉnh eMail
Could not copy information to Clipboard, please try again.	Không thể sao chép thông tin vào Clipboard, xin vui lòng thử một lần nữa.
Error copying to Clipboard	Lỗi sao chép vào Clipboard
Copy to clipboard	Sao chép vào clipboard
Reconvert files	Reconvert tập tin
Are you sure you want to reconvert the selected files?	Bạn có chắc bạn muốn reconvert các tập tin đã chọn không?
Select the files you want to reconvert and then click this button.\r\nIf the original files are still being monitored by MCEBuddy they will be queued for reconversion.	Chọn tập tin bạn muốn reconvert và sau đó nhấp vào này button.\r\nIf các tập tin ban đầu vẫn còn đang được theo dõi bởi MCEBuddy họ sẽ được xếp hàng đợi cho reconversion.
Time taken to convert	Thời gian thực hiện để chuyển đổi
Network authentication	Xác thực mạng
Click the button to enter the network shares credentials.\r\nThis authentication is used when files are added via the Add button on the main window\r\nor dragged and dropped from a network share into the conversion status box on the main window.	Click vào nút để nhập mạng chia sẻ credentials.\r\nThis xác thực được sử dụng khi tập tin được thêm vào thông qua các nút thêm trên window\r\nor chính kéo và thả xuống từ một mạng chia sẻ vào hộp tình trạng chuyển đổi trên cửa sổ chính.
Skip reconversion	Bỏ qua reconversion
Do not reconvert the video if a converted file already exists in the destination directory.	Không nên reconvert video, nếu một tập tin chuyển đổi đã tồn tại trong thư mục đích.
The expected filename for the converted video (not the original video filename) is compared with the filenames in the destination directory.\r\nIf the converted file exists, the file will not be reconverted and it will be assumed to be a successful conversion.\r\nThis is useful if the same show/episode is being recorded on multiple times and you don't want to reconvert them.\r\n\r\nNOTE: This option is ignored for videos that are added manually using the add button or dragging and dropping	Tên tệp dự kiến cho video chuyển đổi (tên không ban đầu video tệp) được so sánh với các tên tập tin trong directory.\r\nIf điểm đến tập tin chuyển đổi tồn tại, các tập tin sẽ không được reconverted và nó sẽ được giả định là một thành công conversion.\r\nThis là hữu ích nếu cùng một hiển thị/tập được ghi lại trên nhiều lần và bạn không muốn reconvert them.\r\n\r\nNOTE: Tùy chọn này bỏ qua cho video được thêm bằng tay bằng cách sử dụng nút Thêm hoặc kéo và thả
If enabled, skip reconversion will also check the history file for past conversions.\r\nThe expected filename for the converted video (not the original video filename) is compared with the filenames in the history file.\r\nIf the to be converted filename (including path) matches any of the already converted filenames (including paths) in the history file,\r\nthe file will not be reconverted and it will be assumed to be a successful conversion.	Nếu kích hoạt, bỏ qua reconversion cũng sẽ xem lịch sử file cho qua conversions.\r\nThe dự kiến sẽ tên tệp cho video chuyển đổi (tên không ban đầu video tệp) được so sánh với các tên tập tin trong file.\r\nIf lịch sử các phải chuyển đổi tên tập tin (bao gồm cả con đường) phù hợp với bất kỳ tên tập tin đã chuyển đổi (bao gồm cả đường dẫn) trong tập tin lịch sử, \r\nthe tập tin sẽ không được reconverted và nó sẽ được giả định là một chuyển đổi thành công.
Adding file to the iTunes library	Thêm tệp vào thư viện iTunes
Add to iTunes	Thêm vào iTunes
Check this box to automatically add the converted files to the iTunes library.\r\nThis only works with iTunes supported files (e.g. MP4, M4V, MP3 etc)	Kiểm tra hộp này để tự động thêm các tập tin chuyển đổi để iTunes library.\r\nThis chỉ làm việc với iTunes tập tin được hỗ trợ (ví dụ như MP4, M4V, MP3 vv)
Adding file to the WMP library	Thêm tệp vào thư viện WMP
Library Management	Quản lý thư viện
Add to Windows Media Player	Thêm vào Windows Media Player
Check this box to automatically add the converted files to the WMP library.	Kiểm tra hộp này để tự động thêm các tập tin chuyển đổi vào thư viện WMP.
Renaming and Sorting	Đổi tên và phân loại
Selection Filters	Lựa chọn bộ lọc
Audio and Video	Âm thanh và Video
Subtitles and Chapters	Phụ đề và chương
Skip copying original files	Bỏ qua sao chép tập tin ban đầu
CHECK THIS BOX AT YOUR OWN RISK.\r\nDO NOT CHECK THIS BOX UNLESS YOU KNOW WHAT YOU ARE DOING.\r\nCheck this box to skip making a backup of original file (copying) while converting.	Kiểm tra này hộp tại riêng của bạn RISK.\r\nDO không kiểm tra này hộp trừ khi bạn biết những gì bạn đang DOING.\r\nCheck hộp này để bỏ qua làm cho bản sao lưu của tập tin gốc (sao chép) trong khi chuyển đổi.
CHECK THIS BOX AT YOUR OWN RISK.\r\nDO NOT CHECK THIS BOX UNLESS YOU KNOW WHAT YOU ARE DOING.\r\nCheck this box to skip making a backup of original file (copying) while converting.\r\nIf this is checked, the original file will not be preserved in case of an error.\r\nIt can also even lead to conversion failures or other unforeseen conversion issues.	RISK.\r\nDO kiểm tra này hộp tại riêng của bạn không có kiểm tra hộp này trừ khi bạn biết những gì bạn đang DOING.\r\nCheck hộp này để bỏ qua làm cho bản sao lưu của tập tin gốc (sao chép) trong khi converting.\r\nIf này được chọn, các tập tin ban đầu sẽ không được bảo quản trong trường hợp một error.\r\nIt có thể thậm chí cũng dẫn đến chuyển đổi thất bại hoặc các vấn đề chuyển đổi không lường trước.
Are you sure you want to do this?	Bạn có chắc bạn muốn làm điều này?
Media Information Management	Quản lý thông tin phương tiện truyền thông
Force show type	Lực lượng hiển thị loại
Set this to force treating the video recording as a Movie or TV Series.\r\nThis will change the way additional information (metadata) about the recording is downloaded from the internet.\r\nMovie - Treat the recording as movie\r\nSeries - Treat the recording as a TV Series\r\nSports - Treat the recording as a Sports show\r\nDefault - Use the default information available in the recording metadata to determine Movie or TV Series	Thiết lập này để buộc điều trị video ghi âm là một bộ phim hay TV Series.\r\nThis sẽ thay đổi cách bổ sung thông tin (siêu dữ liệu) về ca khúc được tải về từ internet.\r\nMovie điều trị - điều trị ghi âm như movie\r\nSeries - điều trị ghi âm là một TV Series\r\nSports - ghi âm là một môn thể thao show\r\nDefault - sử dụng các thông tin mặc định có sẵn trong các siêu dữ liệu ghi âm để xác định bộ phim hoặc phim truyền hình
Show type	Hiển thị loại
Select this to filter the type of recordings being converted.\r\n\r\nMovies - select this to convert if the show type is Movie.\r\nShows - select this to convert if the show type is NOT a Movie.\r\nSports - select this to convert if the show type is Sports.\r\n\r\nNOTE: Show type is read from the recording metadata.\r\nOnly some recordings support show type metadata such as WTV and\r\nrecordings with supporting metadata files (XML/ARG etc).	Chọn tùy chọn này để lọc loại bản ghi âm là converted.\r\n\r\nMovies - chọn tùy chọn này để chuyển đổi nếu loại Hiển thị là Movie.\r\nShows - chọn tùy chọn này để chuyển đổi nếu loại Hiển thị không phải là một Movie.\r\nSports - chọn tùy chọn này để chuyển đổi nếu loại Hiển thị là Sports.\r\n\r\nNOTE: Hiển thị loại được đọc từ metadata.\r\nOnly ghi âm bản thu âm một số hỗ trợ hiển thị loại siêu dữ liệu chẳng hạn như WTV and\r\nrecordings với hỗ trợ siêu dữ liệu tập tin ()XML/ARG vv).
This box shows all the files in queue for conversion.\r\nDrag and drop files here or press the Add button to add files to the conversion queue	Hộp này cho thấy tất cả các tập tin trong hàng đợi cho conversion.\r\nDrag và thả tập tin ở đây hoặc bấm vào nút Add để thêm tệp vào danh sách chờ chuyển đổi
Conversion	Chuyển đổi
Files	Tập tin
Click this button to open or close the Advanced Settings section	Nhấp vào nút này để mở hoặc đóng phần cài đặt nâng cao
Running custom commands	Chạy lệnh riêng
Trimming video recording	Trang trí quay video
Insert at top of queue	Chèn ở trên cùng của danh sách chờ
By default, new conversions are added to the bottom (end) of the conversion queue.\r\nIf this box is checked, any new conversions added by this task will be added to the\r\nbeginning (top) of the conversion queue.	Theo mặc định, chuyển đổi mới được thêm vào dưới cùng (cuối cùng) của queue.\r\nIf chuyển đổi hộp này được chọn, bất kỳ chuyển đổi mới được thêm vào của nhiệm vụ này sẽ được thêm vào the\r\nbeginning (top) hàng chờ chuyển đổi.
Add subtitles and chapters	Thêm phụ đề và chương
Enable this option to add any extracted subtitles and chapters to the converted video.\r\nEach chapter marks the end of a commercial. This only works with supported formats (e.g. MKV, MP4).\r\n\r\nNOTE: Some players and older TV's don't support embedded subtitles and chapters.\r\nIf you're unable to playback the converted video's, try turning this option off.	Bật tùy chọn này để thêm bất kỳ phụ đề chiết xuất và chương để chuyển đổi video.\r\nEach chương đánh dấu sự kết thúc của một thương mại. Điều này chỉ làm việc với các định dạng được hỗ trợ (ví dụ như MKV, MP4).\r\n\r\nNOTE: một số cầu thủ và TV cũ hơn không hỗ trợ phụ đề nhúng và chapters.\r\nIf bạn không thể phát lại video chuyển đổi, hãy thử tắt tùy chọn này.
Select best soundtrack	Chọn nhạc hay nhất
If the original video has multiple soundtracks, this option tells MCEBuddy to select the most appropriate and primary soundtrack.\r\nIf you want a specific language soundtrack, make sure you enter the language name or code in the Audio Language box.\r\nCheck this box if you're hearing the wrong soundtrack in your converted file.\r\n\r\nUncheck this box if you want MCEBuddy to retain all the soundtracks from the original video in the converted file when possible.\r\nNOTE:Some profiles do not support multiple soundtracks, in which case this setting has no effect.	Nếu video gốc có nhiều nhạc phim, tùy chọn này cho biết MCEBuddy để chọn soundtrack.\r\nIf đặt thích hợp và chính bạn muốn một nhạc ngôn ngữ cụ thể, hãy chắc chắn rằng bạn nhập tên ngôn ngữ hoặc mã trong ngôn ngữ âm thanh box.\r\nCheck hộp này nếu bạn đang nghe nhạc sai ở của bạn file.\r\n\r\nUncheck chuyển đổi hộp này nếu bạn muốn MCEBuddy để giữ lại tất cả các nhạc từ video gốc trong tập tin chuyển đổi khi có thể. \r\nNOTE: một số hồ sơ không hỗ trợ nhiều nhạc phim, trong trường hợp cài đặt này không có hiệu lực.
Enable remote access	Cho phép truy nhập từ xa
This creates an exception in the windows firewall for MCEBuddy application and the port.\r\nThis is required if you have windows firewall enabled and want to use UPnP, the remote client\r\nor access the engine using an IP address.\r\n\r\nNOTE: If you have a custom firewall, this may not work, you will need to manually create an\r\nexception for MCEBuddy service and the port.	Điều này tạo ra một ngoại lệ trong tường lửa của windows cho ứng dụng MCEBuddy và port.\r\nThis là bắt buộc nếu bạn có tường lửa của windows được kích hoạt và muốn sử dụng UPnP, truy cập từ xa client\r\nor động cơ bằng cách sử dụng một address.\r\n\r\nNOTE IP: nếu bạn có một tường lửa tùy chỉnh, điều này có thể không làm việc, bạn sẽ cần phải tự tạo an\r\nexception cho MCEBuddy dịch vụ và cảng.
Unable to communicate with engine. Firewall exception settings have not been updated.	Không thể giao tiếp với động cơ. Thiết đặt ngoại lệ tường lửa đã không được Cập Nhật.
Detect and optimize video quality	Phát hiện và tối ưu hóa chất lượng video
When enabled, MCEBuddy will optimize the video processing options by trying to detect the video source type.\r\nThis can improve the quality of the converted video significantly if correctly detected.\r\n\r\nNOTE: It does this by trying to detect the video source type (interlaced, progressive or telecine).\r\nIf it is able to detect the video source type, it will override the corresponding parameters in the profile.\r\nTurn this option off if you are facing issues with converted video quality or want to use the default profile parameters.	Khi kích hoạt, MCEBuddy sẽ tối ưu hóa các tùy chọn xử lý video bằng cách cố gắng để phát hiện type.\r\nThis nguồn video có thể cải thiện chất lượng của video chuyển đổi đáng kể nếu một cách chính xác detected.\r\n\r\nNOTE: nó thực hiện điều này bằng cách cố gắng để phát hiện loại nguồn video (xen kẽ, tiến bộ hoặc telecine).\r\nIf nó có thể phát hiện các loại nguồn video, nó sẽ ghi đè lên các tham số tương ứng trong profile.\r\nTurn này lựa chọn ra nếu bạn đang phải đối mặt với các vấn đề với chất lượng video đã được chuyển đổi hoặc muốn sử dụng các tham số cấu hình mặc định.
Are you sure you want to delete this task?	Bạn có chắc bạn muốn xóa bỏ tác vụ này không?
Delete Task	Xóa bỏ tác vụ
Enter the new task name	Nhập tên tác vụ mới
Rename Task	Đổi tên nhiệm vụ
MCEBuddy PAUSED	MCEBuddy tạm dừng
idle	nhàn rỗi
PAUSED	TẠM DỪNG
Frame rate	Tỷ lệ khung hình
Enable this to set a custom framerate (FPS) for the converted video.\r\nYou may need to set this while converting video formats (e.g. PAL to NTSC)\r\nor for devices which support only specific framerates.\r\n\r\nE.g.: 25\r\nE.g.: 30000/1001	Sử này để thiết lập một framerate tùy chỉnh (FPS) cho video.\r\nYou chuyển đổi có thể cần phải đặt điều này trong khi chuyển đổi định dạng video (ví dụ như PAL để NTSC) \r\nor cho các thiết bị hỗ trợ chỉ cụ thể framerates.\r\n\r\nE.g.: 25\r\nE.g.: 30000/1001
Skip remuxing files	Bỏ qua các tập tin remuxing
CHECK THIS BOX AT YOUR OWN RISK.\r\nDO NOT CHECK THIS BOX UNLESS YOU KNOW WHAT YOU ARE DOING.\r\nCheck this box to skip remuxing the original file to a TS file while converting.\r\nIf this is checked, some functions like subtitle extraction or comskip may not work.\r\nIt can also even lead to conversion failures or other unforeseen conversion issues.	RISK.\r\nDO kiểm tra này hộp tại riêng của bạn không có phòng này hộp trừ khi bạn biết những gì bạn đang DOING.\r\nCheck hộp này để bỏ qua remuxing tập tin gốc để một TS tập tin trong khi converting.\r\nIf này được chọn, một số chức năng như phụ đề khai thác hoặc comskip có thể không work.\r\nIt có thể thậm chí cũng dẫn đến chuyển đổi thất bại hoặc các vấn đề chuyển đổi không lường trước.
CHECK THIS BOX AT YOUR OWN RISK.\r\nDO NOT CHECK THIS BOX UNLESS YOU KNOW WHAT YOU ARE DOING.\r\nCheck this box to skip remuxing the original file to a TS file while converting.	Kiểm tra này hộp tại riêng của bạn RISK.\r\nDO không kiểm tra này hộp trừ khi bạn biết những gì bạn đang DOING.\r\nCheck hộp này để bỏ qua remuxing tập tin gốc để một TS tập tin trong khi chuyển đổi.
Monitor converted videos	Theo dõi chuyển đổi video
By default Monitor Locations will ignore files that have already been converted.\r\nCheck this box if you also want to monitor converted files in the Monitor Path.\r\nCAUTION: This can lead to an infinite conversion loop of converted files if not configured properly.\r\n\r\nThis can be useful when you are specifying the output directory of a conversion task\r\n(converted file) as the Monitor Path of a Monitor Location and linking the\r\nMonitor Location to another conversion task.	Theo mặc định vị trí giám sát sẽ bỏ qua tập tin đã là converted.\r\nCheck hộp này nếu bạn cũng muốn theo dõi các tập tin chuyển đổi trong màn hình Path.\r\nCAUTION: điều này có thể dẫn đến một vòng lặp vô hạn chuyển đổi của tập tin chuyển đổi nếu không được cấu hình properly.\r\n\r\nThis có thể là hữu ích khi bạn được chỉ định thư mục đầu ra của một chuyển đổi task\r\n (chuyển đổi tập tin) là đường dẫn màn hình của vị trí màn hình và liên kết the\r\nMonitor Vị trí đến một chuyển đổi công việc.
CHECK THIS BOX AT YOUR OWN RISK.\r\nDO NOT CHECK THIS BOX UNLESS YOU KNOW WHAT YOU ARE DOING.\r\nBy default Monitor Locations will ignore files that have already been converted.\r\nCheck this box if you also want to monitor converted files in the Monitor Path.	Kiểm tra này hộp tại riêng của bạn RISK.\r\nDO không kiểm tra này hộp trừ khi bạn biết những gì bạn đang DOING.\r\nBy mặc định màn hình trí sẽ bỏ qua tập tin đã là converted.\r\nCheck hộp này nếu bạn cũng muốn theo dõi các tập tin chuyển đổi trong đường dẫn màn hình.
Hardware encoding	Phần cứng mã hóa
Check this box to use hardware encoding when available to convert videos.\r\nThis can speed up the conversion significantly and reduce the CPU utilization\r\nbut it can result in slightly lower quality videos.\r\n\r\nUncheck this box if you're facing conversion or quality issues.	Kiểm tra hộp này để sử dụng phần cứng mã hóa khi có sẵn để chuyển đổi videos.\r\nThis có thể tăng tốc độ chuyển đổi đáng kể và làm giảm utilization\r\nbut CPU nó có thể dẫn đến hơi thấp hơn chất lượng videos.\r\n\r\nUncheck điều này hộp nếu bạn đang phải đối mặt với chuyển đổi hoặc vấn đề chất lượng.
Do not overwrite files	Không ghi đè lên tập tin
When this box is checked, the destination file will not be overwritten if it already exists.\r\nInstead a new file will be created with a unique number added to the end of the filename.	Khi hộp này được chọn, tập tin đích sẽ không được ghi đè nếu nó đã exists.\r\nInstead một tập tin mới sẽ được tạo ra với một số duy nhất thêm vào cuối tên tập tin.
Re-monitor recorded videos	Tái giám sát ghi lại video
By default, once a source file (Recorded video) has been converted,\r\nthe monitor history will track the filename and not queue the same files again.\r\n\r\nEnable this option to ignore the history and monitor all files and add them to\r\nthe conversion queue, even if they have already been converted.\r\n\r\nThis can be useful sometimes, if the recording software does not generate a\r\nunique filename for each episode/show. It is reccomended to use the\r\nDelete original file option in the Settings page when using this option to avoid\r\nan infinite conversion loop.	Theo mặc định, một khi một tập tin nguồn (Recorded video) đã được chuyển đổi, \r\nthe màn hình lịch sử sẽ theo dõi các tên tập tin và không phải xếp hàng cùng một tập tin again.\r\n\r\nEnable tùy chọn này để bỏ qua lịch sử và giám sát tất cả các tập tin và thêm chúng to\r\nthe chuyển đổi hàng đợi, ngay cả khi họ đã converted.\r\n\r\nThis có thể hữu ích đôi khi, nếu phần mềm ghi âm không tạo ra a\r\nunique tên tập tin cho mỗi tập/Hiển thị. Nó là reccomended để sử dụng the\r\nDelete ban đầu tập tin tùy chọn trong trang cài đặt khi sử dụng tùy chọn này để avoid\r\nan vô hạn chuyển đổi vòng lặp.
Recommendation	Đề nghị
To avoid an infinite conversion loop, it is recommended to setup your Monitor search pattern in a way such as to ensure that the converted files are not being monitored by this Monitor task.	Để tránh một vòng lặp vô hạn chuyển đổi, nó được khuyến khích để thiết lập mô hình tìm màn hình của bạn theo một cách chẳng hạn như để đảm bảo rằng các tập tin chuyển đổi đang không được theo dõi bởi nhiệm vụ màn hình này.
CHECK THIS BOX AT YOUR OWN RISK.\r\nDO NOT CHECK THIS BOX UNLESS YOU KNOW WHAT YOU ARE DOING.\r\nBy default Monitor Locations will not remonitor recorded videos that have been processed.\r\nCheck this box if you want to remonitor and reconvert the recorded videos.	Kiểm tra này hộp tại riêng của bạn RISK.\r\nDO không kiểm tra này hộp trừ khi bạn biết những gì bạn đang DOING.\r\nBy mặc định vị trí giám sát sẽ không remonitor ghi lại video đã được processed.\r\nCheck hộp này nếu bạn muốn remonitor và reconvert các video được ghi lại.
To avoid an infinite conversion loop, it is recommended that you enable Delete original file option in the Settings page.	Để tránh một vòng lặp vô hạn chuyển đổi, đó khuyến cáo rằng bạn cho phép tùy chọn xóa tập tin ban đầu trong trang cài đặt.
Prioritize air date matching	Ưu tiên máy ngày kết hợp
MCEBuddy uses the episode name to match the series information\r\nwhile searching the internet. If that fails then it uses the original broadcast\r\nair date to match the metadata.\r\n\r\nCheck this box to use the original broadcast air date first and then the\r\nepisode name to match for the series information from the internet.\r\nThis can be useful in some cases when multiple seasons have the same\r\nepisode name. E.g. Americal Idol, Audition 1\r\n\r\nNOTE: Original broadcast air date is not always accurate set by the\r\nbroadcaster and sometimes the information on the internet is incorrect.\r\nUse this option only if the default option is not working for you.	MCEBuddy sử dụng tên tập để phù hợp với loạt information\r\nwhile tìm kiếm trên internet. Nếu thất bại sau đó nó sử dụng ngày broadcast\r\nair ban đầu để phù hợp với metadata.\r\n\r\nCheck hộp này để sử dụng máy phát sóng ngày ban đầu đầu tiên và sau đó the\r\nepisode tên để phù hợp với những loạt thông tin từ internet.\r\nThis có thể hữu ích trong một số trường hợp khi nhiều mùa có tên same\r\nepisode. Ví dụ: Americal Idol, Audition 1\r\n\r\nNOTE: ban đầu máy phát sóng ngày luôn luôn không phải là các thiết lập chính xác bởi the\r\nbroadcaster và đôi khi các thông tin trên internet là incorrect.\r\nUse điều này tùy chọn chỉ khi các tùy chọn mặc định không làm việc cho bạn.
Skip eMail body	Bỏ qua thư điện tử cơ thể
Check this option to use an empty body in the notification eMail.\r\nThis can be useful if you're using a SMS gateway for eMail notifications.	Kiểm tra tuỳ chọn này để sử dụng một cơ thể sản phẩm nào trong eMail.\r\nThis thông báo có thể hữu ích nếu bạn đang sử dụng một cửa ngõ SMS cho thông báo eMail.
Selection based on Digital Right Management (DRM) is available\r\nonly when Rename without converting (Rename and move only) option is selected.\r\n\r\nAll - Selects all files for processing, irrespective of copy protection status\r\nProtected - Only select files which are copy protected\r\nUnprotected - Only select files which do not have copy protection	Lựa chọn dựa trên quản lý quyền kỹ thuật số (DRM) là available\r\nonly khi đổi tên mà không chuyển đổi (đổi tên và di chuyển chỉ) tùy chọn là selected.\r\n\r\nAll - chọn tất cả các tập tin để xử lý, không phân biệt bản sao bảo vệ status\r\nProtected - chỉ chọn tập tin có bản sao protected\r\nUnprotected - chỉ chọn tập tin mà không có bản sao bảo vệ
Download cover art	Tải về bìa
Enable this to download the cover art from the original video and internet if available.	Cho phép này để tải bìa từ video gốc và internet nếu có sẵn.
Are you sure you want to enter a Domain Name?\r\n\r\nUse this ONLY if you are using a Windows Domain Controller to manage your authentication.\r\nDo NOT use this if you are part of a Workgroup.\r\n\r\nIf you are unsure click NO.	Bạn có chắc bạn muốn nhập vào một tên miền? \r\n\r\nUse này chỉ nếu bạn đang sử dụng bộ kiểm soát miền Windows để quản lý của bạn authentication.\r\nDo không sử dụng nếu bạn là một phần của một Workgroup.\r\n\r\nIf bạn là không chắc chắn nhấp chuột không
Configuration Warning	Cấu hình cảnh báo
Creates a folder called 'MCEBuddyArchive' where the original file is located\r\nand moves the orginal file in this directory after a successful conversion.\r\n\r\nThis folder name and location be changed below.	Tạo ra một thư mục có tên 'MCEBuddyArchive' nơi các tập tin ban đầu là located\r\nand di chuyển các tập tin gốc trong thư mục này sau khi một thành công conversion.\r\n\r\nThis thư mục tên và vị trí được thay đổi dưới đây.
Monitoring	Giám sát
If you want to convert the EDL file into chapters, make sure you check the 'Add Subtitles and Chapters' option in Expert Settings.	Nếu bạn muốn chuyển đổi các tập tin EDL thành chương, đảm bảo rằng bạn kiểm tra các tùy chọn 'Thêm phụ đề và chương' trong cài đặt chuyên gia.
EDL to Chapters	EDL chương
