MCEBuddy does NOT use the currently logged in user to connect to network shares, it uses its own service account.  Be sure to specify the connection user information (MCEBuddy with a key icon)	MCEBuddy 不使用當前登錄的使用者連接到網路共用，它使用其自己的服務帳戶。請確保指定的連接使用者資訊 （MCEBuddy 的一個鑰匙圖示）
Connection Reminder	連接的提醒
Description	說明
Path	路徑
is invalid	是無效的
Invalid Path	無效的路徑
Please supply a task name	請任務名稱，提供
No name supplied	沒有提供的名稱
Please enter the 3 digit language code of the Audio track or select <Default> or <Original>	請輸入音訊軌道或選擇 <Default>或 <Original>的 3 位語言代碼
The 3 digit ISO code for the selected language\r\nMake sure this matches the language code for the audio track in the original recording.\r\nTo get the language code for the audio tracks in the original recorded file, add the file\r\nto the queue and right click on it. A pop up window will open showing the audio details\r\nwhich include the language codes for each audio track.	3 位確保這與匹配原始 recording.\r\nTo get 在原始的記錄檔的音訊軌道的語言代碼中的音訊軌道的語言代碼的選定 language\r\nMake ISO 代碼添加 file\r\nto 佇列，並按右鍵它。將會打開一個快顯視窗來顯示音訊 details\r\nwhich 包括每個音訊軌道的語言代碼。
Invalid Language Code	無效的語言代碼
No destination directory provided, converted file will be placed in original video directory	沒有目標目錄提供，轉換後的檔將放置在原始視頻目錄
A task name or section	任務名稱或節
already exists\n\rPlease use another name	exists\n\rPlease 已使用另一個名稱
Duplicate Name	重複的名稱
Engine	發動機
Tasks	任務
Profile	設定檔
disposing	處置
Task name	任務名稱
Give a unique name to this task	這項任務提供唯一的名稱
Gives a short description for the selection conversion profile	給出的選擇轉換設定檔的簡短描述
Click to select destination folder	按一下以選擇目的檔案夾
Destination	目標
Select the directory where the converted file will be placed.\r\nLeave this blank to keep the converted file in the same directory as the original video.	選擇轉換後的檔將這個空白，以保留原始的相同目錄中的轉換後的檔視頻 placed.\r\nLeave 的目錄。
Max width	最大寬度
This will limit the maximum width (in pixels) of the video for the converted file.\r\nTIP: Does not apply if the original file has a width smaller than this number.\r\nIf you want to keep your original video resolution move the slider all the way to the right.	這將限制為轉換後的 file.\r\nTIP 視頻的最大寬度 （以圖元為單位）： 如果原始檔具有寬度小於此要保留你的原始視頻解析度移動滑塊到最右邊的 number.\r\nIf 不適用。
Quality	品質
Ad remover	Ad 卸妝
None	無
Get series details from Internet	從互聯網獲取系列詳細資訊
Download additional details about the movie or series from the internet	從互聯網下載影片或系列有關其他詳細資訊
File name match	匹配的檔案名稱
Recording title match	錄製標題匹配
Cancel	取消
OK	還行
Rename without converting	不進行轉換，重命名
Check this option to only rename and copy the original files to the destination folder.\r\nWhen checked, conversion, trimming, audio/video processing and commercial removal will not be available.\r\n\r\nNOTE: Other functions like matching filters, extracting subtitles, saving metadata and commercial detection (saving EDL file)\r\nwill still be available with this option checked.\r\nIf you want to move instead of copy, check the Skip copying original option in Expert Settings on this page or select\r\nDelete original file in the main settings page.	檢查選中此選項只重命名，並將原始檔案複製到目的地 folder.\r\nWhen、 轉換、 裁切、 音訊/視頻處理和商業去除不會 available.\r\n\r\nNOTE： 其他功能，如匹配的篩選器，提取字幕，保存中繼資料和商業檢測 (EDL 檔保存) \r\nwill 仍然可與您想要移動而不是複製此選項 checked.\r\nIf請跳過此頁或 select\r\nDelete 的原始檔案，在主要設置頁上的專家設置中複製原始選項檢查。
Rename and sort by video information	重命名，並通過視頻資訊進行排序
Renames the converted file and places it in a new directory based on the show/series information when available\r\n(e.g. ShowName\\ShowName-SXXEYY-EpisodeName-RecordDate)	重命名已轉換的檔並將其放在一個新的目錄，基於顯示/系列的資訊時 （例如 ShowName\\ShowName-SXXEYY-EpisodeName-RecordDate) available\r\n
Enter the username and password to access folders that are on a network drive or a different computer	輸入的使用者名和密碼以訪問網路磁碟或不同電腦上的資料夾
Organize by seasons	按季節組織
Organize folders by Showname and Season when available (Media Center/XBMC/Plex compatible naming convention)\r\n(e.g. Showname\\Season XX\\SXXEYY-Episode Name)	組織資料夾的 Showname 和季節時可用 （媒體中心/XBMC/叢相容命名約定） \r\n （例如 Showname\\Season XX\\SXXEYY 集名稱）
Audio language	音訊語言
Advanced Settings	高級的設置
General Settings	常規設置
Conversion Task	轉換任務
Password	密碼
Confirm Password	確認密碼
Domain / computer name	域 / 電腦名稱
<Optional> Enter if remote computer or network drive uses a Domain for authentication.\r\nDo NOT enter your workgroup here. Leave this blank if you're using a workgroup.	如果遠端電腦或網路磁碟機使用的功能變數名稱為 authentication.\r\nDo 的 <Optional>輸入不輸入您的工作組在這裡。這將保留為空，如果你使用一個工作組。
User name	使用者名稱
Enter the username to access the remote computer or network drive	輸入的使用者名來訪問遠端電腦或網路磁碟
Enter the password to access the remote computer or network drive	輸入密碼以訪問遠端電腦或網路磁碟
Network Connection User Credentials	網路連接使用者憑據
Password Mismatch	密碼不匹配
Passwords do not match, please reenter the passwords	密碼不匹配，請重新輸入密碼
Hour	小時
Minute	分鐘
Wake	喚醒
Start	啟動
Resume	簡歷
Pause	暫停
Stop	停止
Language	語言
Pause conversion tasks	暫停轉換任務
Resume conversion tasks	繼續執行轉換任務
Please enter a valid time	請輸入一個有效的時間
Invalid Time	無效的時間
Stop time is after Start time. Assuming the Stop time is during the next day, is that correct?	停止時間是在開始時間之後。假設的停止時間在第二天，這是否正確嗎？
Time Check	時檢查
Only select this option if MCEBuddy has been converting your files reliably for an acceptable period of time. Do you wish MCEBuddy to delete each original file once it has been converted?	如果 MCEBuddy 已經被轉換您的檔可靠地可接受的一段時間，才選擇此選項。是否要刪除的每個原始檔，一旦已轉換的 MCEBuddy 嗎？
Confirm delete originals?	確認刪除原始檔嗎？
MCEBuddy will monitor these directories for video files to convert automatically	MCEBuddy 將會監察這些視頻檔將自動轉換為目錄
Conversion tasks	轉換任務
Delete original file	刪除原始檔
Deletes the original recording after a successful conversion	刪除成功轉換後的原始錄音
Min age before conversion (hours)	在轉換之前的最小年齡 (小時)
Minimum hours to wait before converting each file after the file is added to the queue	將每個檔轉換後將檔添加到佇列之前要等待的最短時間
Use this to change the language of the text on the screen	使用它可以改變螢幕上的文本的語言
Concurrent conversions	併發轉換
Number of simultaneous conversions MCEBuddy can start\r\nNOTE: You need large amounts of free disk space and processor time for more than 2 simultaneous conversions	同時轉換 MCEBuddy 的數目可以 start\r\nNOTE： 您需要大量的可用磁碟空間和處理器時間超過 2 同時轉換為
Logging level	日誌記錄級別
Error	錯誤
Warning	警告
Information	資訊
Debug	調試
Log conversion jobs	日誌轉換作業
Save a log file for each conversion in the \'logs\' directory where where MCEBuddy is installed\r\n(e.g. C:\\Program Files\\MCEBuddy2x\\logs)	在 \'logs\ 中保存一個日誌檔，每個轉換 ' 凡其中 MCEBuddy 是 installed\r\n （例如 C:\\Program Files\\MCEBuddy2x\\logs) 的目錄
Allow sleep	允許睡眠
If unchecked, it prevents the system from entering sleep while converting	如果未選中，它可以防止系統進入睡眠轉換時
Stop at	在停止
No new conversions would be started after this time	將此時間後，不開始任何新的轉換
minute	分鐘
hour	小時
If checked MCEBuddy will wake the system from sleep\r\nat the specified Start time and enabled days of the week.	如果檢查 MCEBuddy 將喚醒系統 sleep\r\nat 從指定的開始時間和啟用了周中的天。
Start at	在啟動
MCEBuddy will start new conversions between the Start and Stop time.\r\n\r\nThe Start time will be used for the enabled days of the week, whereas\r\nthe End time will be used either for the same day or\r\nfor the next day if the End time is after the Start time.	MCEBuddy 將啟動新轉換之間開始和停止 time.\r\n\r\nThe 開始將啟用天一周的使用時間，whereas\r\nthe 結束時間將使用或者為同一天 or\r\nfor，第二天如果結束時間是開始時間之後。
Delete	刪除
Add	添加
Change	變化
Archive original file	存檔原始檔
Domain name	功能變數名稱
Stops the monitor and conversion tasks and opens a page to configure MCEBuddy	停止的監視器和轉換任務，並打開一個頁面來配置 MCEBuddy
Creates a folder called \'MCEBuddyArchive\' where the original file is located\r\nand moves the orginal file in this directory after a successful conversion.\r\n\r\nThis folder name and location be changed in the System Settings page.	創建名為 \'MCEBuddyArchive\ 的資料夾 ' 原始檔案所在的 located\r\nand 移動此目錄中的原始檔案之後在系統設置頁中更改成功 conversion.\r\n\r\nThis 資料夾名稱和位置。
Debug - detailed logs, helps trace conversion problems\r\nInformation - logs basic information about conversion\r\nWarning - log potential issues or critical failures only\r\nError - log critical failures only	調試-詳細的日誌，可以説明跟蹤轉換 problems\r\nInformation-基本資訊關於 conversion\r\nWarning 的日誌-日誌潛在的問題或嚴重故障 only\r\nError-日誌只嚴重故障
Select the conversion profile associated with this task. The conversion profile represents the output format and quality for the converted file.\r\nHigher quality conversions take longer to convert. Reccomended Default: MP4 High Quality or MP4 Normal.\r\n\r\nTIP: Refer to the MCEBuddy Guide for advanced parameters to tweak conversion profiles or to create your own conversion profiles	選擇與此任務關聯的轉換設定檔。轉換設定檔表示的輸出格式和轉換需要較長時間將轉換為轉換後的 file.\r\nHigher 品質。建議的預設值： MP4 高品質或 MP4 Normal.\r\n\r\nTIP: MCEBuddy 指南高級參數調整轉換設定檔或創建您自己的轉換設定檔，請參閱
Select the program MCEBuddy will use to strip out any commercials while converting the video.\r\nSet to 'None' to leave the commercials in the converted video.\r\n\r\nTIP: To use ShowAnalyzer instead of Comskip, please download and install ShowAnalyzer.\r\nShow Analyzer version 1.0 and greater supported.	選擇的程式 MCEBuddy 將使用轉換為無離開廣告在轉換後的 video.\r\n\r\nTIP video.\r\nSet 同時剔除任何廣告： 使用 ShowAnalyzer 而不是 Comskip，請下載並安裝 ShowAnalyzer.\r\nShow 分析器版本 1.0 和更大的支援。
Used to change the video quality of the converted file, normal is 1.\r\nA higher number will improve quality but will take more time for conversion.\r\nA smaller number will reduce the quality but speed up the conversion.	用於更改轉換後，正常的視頻品質是檔的 1.\r\nA 高數量將提高品質，但 conversion.\r\nA 較小的數位將會降低品質但加快轉換將採取更多的時間。
Enter pattern to match filenames for this task (e.g. *.wtv will convert all files ending with .wtv)\r\nPrefix pattern with ~ to skip the match (e.g. *.*;~*.wtv will process all files except those ending with .wtv)\r\nSeparate multiple patterns with ; (e.g. *.wtv;ncis*;~ncis miami*) will process all .wtv files and all files starting with ncis but not those starting with ncis miami\r\n\r\nYou can use regular expressions to match the pattern by starting with regex:	輸入要匹配此任務的檔案名模式 （如 *.wtv 會將轉換以.wtv)\r\nPrefix 模式與結尾的所有檔 ~ 要跳過這場比賽 （例如 *。 * ； ~*.wtv 將處理所有的檔，除了那些以.wtv)\r\nSeparate 結尾與多個模式 ；（例如，*.wtv ； 海軍罪案調查處 *; ~ 海軍罪案調查處邁阿密 *) 將過程.wtv 的所有檔和所有檔與海軍罪案調查處開始，但不是那些與海軍罪案調查處 miami\r\n\r\nYou 開始可以使用正則運算式與模式匹配的正則運算式從開始：
Enter pattern to match show/series titles for this task (e.g. Simpson* will convert all files that have a show title starting with Simpson)\r\nPrefix pattern with ~ to skip the match (e.g. *;~Simpson* will process all show titles except those that start with Simpson)\r\nSeparate multiple patterns with ; (e.g. Simpson*;House*) or (e.g. Simpson*;NCIS*;~NCIS Miami*)\r\n\r\nYou can use regular expressions to match the pattern by starting with regex:	輸入要匹配顯示/系列標題 （例如辛普森 * 將轉換與辛普森開始具有顯示標題的所有檔） 此任務模式 \r\nPrefix 模式與 ~ 要跳過這場比賽 （例如 * ； ~ 辛普森 * 將處理所有顯示書名，開始與辛普森的除外） \r\nSeparate 多模式 ；(例如辛普森 * ；House*） 或 （例如辛普森 * ；NCIS*; ~ 海軍罪案調查處邁阿密 *) \r\n\r\nYou 可以使用正則運算式與模式匹配的正則運算式從開始：
This can be used to override the default Audio Language when there are multiple audio languages in a recording.\r\nTo get the list of the Audio Languages in a recording, right click on the file in the queue and select MediaInfo.\r\n\r\n<Default> will try to keep all audio tracks if supported or let the encoder choose the default audio track\r\n<Original>, if available, will use the original [non-dubbed] recording language	這可以用來重寫的預設的音訊語言 recording.\r\nTo get 中錄製的音訊語言的清單中的多個音訊語言在佇列中的檔上按右鍵，並選擇 MediaInfo.\r\n\r\n <Default>時將嘗試阻止所有音訊軌道，如果支援或讓編碼器選擇預設音訊 track\r\n <Original>如果可用，將使用 [非配音] 錄音原文
Enter '[video]' or leave blank to convert all video files\r\nEnter pattern to match filenames for this location (e.g. *.wtv will convert all files ending with .wtv)\r\nPrefix pattern with ~ to skip the match (e.g. *.*;~*.wtv will process all files except those ending with .wtv)\r\nSeparate multiple patterns with ; (e.g. *.wtv;ncis*;~ncis miami*) will process all .wtv files and all files starting with ncis but not those starting with ncis miami	輸入 '[視頻]' 或保留為空以轉換要匹配檔案名，此位置的所有視頻 files\r\nEnter 模式 （例如 *.wtv 將轉換以.wtv)\r\nprefix 模式的結尾的所有檔 ~ 要跳過這場比賽 （例如 ＊。 ＊ ； ~*.wtv 將處理所有的檔，除非那些以.wtv)\r\nseparate 結尾與多個模式 ；（如 *.wtv ； ncis ＊ ； ~ 調處邁阿密 ＊） 將處理.wtv 的所有檔和所有檔開頭調處，但不是那些開始調處邁阿密
MCEBuddy Settings	MCEBuddy 設置
MCEBuddy does NOT use the currently logged in user to connect to network shares, it uses its own service account.  Be sure to specify the connection user information [MCEBuddy with a key icon]	MCEBuddy 不使用當前登錄的使用者連接到網路共用，它使用其自己的服務帳戶。請確保指定的連接使用者資訊 [MCEBuddy 與一個鑰匙圖示]
Please supply a source name	請提供一個源名稱
Please supply a search path name	請提供一個搜索路徑名稱
A source name or section	源名稱或節
already exists. Please use another name	已存在。請使用另一個名稱
Monitor name	顯示器名稱
Give this a location a unique name	這給一個唯一的名稱的位置
Monitor path	監視器的路徑
Select the directory that MCEBuddy will monitor in the background for new video files to convert automatically	在新的視頻檔將自動轉換為背景中選擇 MCEBuddy 將監視的目錄
Click to select the folder to monitor	按一下以選擇要監視的資料夾
Search pattern	搜索模式
SourceForm	SourceForm
Monitor Location	顯示器位置
Normal	正常
MCEBuddy GUI: pipeProxy engine connection error	MCEBuddy GUI： pipeProxy 引擎連接錯誤
MCEBuddy GUI: Unable to create pipe to MCEBuddy service	MCEBuddy GUI： 無法創建到 MCEBuddy 服務的管道
The MCEBuddy service is unavailable. Please start from Windows control panel or check engine connection.	MCEBuddy 服務不可用。請從 Windows 控制台啟動或檢查引擎的連接。
Announcement	公告
New version 	新版本
available	可用
New BETA version 	新的測試版
Click here to download new version of MCEBuddy	按一下此處下載新版本的 MCEBuddy
Click here to open link	按一下此處可打開連結
Idle	空閒
Closing	關閉
MCEBuddy GUI: Unable to update tasks	MCEBuddy GUI： 無法更新任務
MCEBuddy GUI: Unable to start MCEBuddy service	MCEBuddy GUI： 無法啟動 MCEBuddy 服務
MCEBuddy GUI: Unable to stop MCEBuddy service	MCEBuddy GUI： 無法停止服務 MCEBuddy
MCEBuddy GUI: Unable to cancel job	MCEBuddy GUI： 無法取消作業
Warning: Networked files will be accessed using the logon credentials of the MCEBuddy Service, not the currently logged on user. You can manually specify the network credentials from the Settings -> Expert Settings page in MCEBuddy.	警告： 將使用 MCEBuddy 的服務，不是當前登錄的使用者的登錄憑據訪問網路的檔。在 MCEBuddy 中，你可以手動指定-> 專家設置版面設定中的網路憑據。
Credential Warning	憑據警告
Status	狀態
MCEBuddy GUI: Unable to add job	MCEBuddy GUI： 無法添加作業
MCEBuddy GUI: Unable to get pipe active status	MCEBuddy GUI： 無法獲得管活動狀態
The conversions must be stopped to change settings. Stop the conversions?	若要更改設置，必須停止轉換。停止轉換嗎？
Stop Engine	停止引擎
MCEBuddy GUI: Unable to stop MCEBuddy service from settings click	MCEBuddy GUI： 無法停止從設置按一下 MCEBuddy 服務
MCEBuddy GUI: Unable to rescan files	MCEBuddy GUI： 無法重新掃描檔
MCEBuddy GUI: Unable to open link	MCEBuddy GUI： 無法打開連結
Close	關閉
Close this window, MCEBuddy will keep running in the background	關閉此視窗中，MCEBuddy 將保持在後臺運行
If you like MCEBuddy, please click here to Donate - THANKS	如果您喜歡 MCEBuddy，請按一下此處捐款-謝謝
Click here to like MCEBuddy on facebook	按一下此處可在 facebook 上喜歡 MCEBuddy
Click here to open MCEBuddy website	按一下此處打開 MCEBuddy 網站
Rescan	重新掃描
Forces the MCEBuddy to recheck the Monitor locations for new video files to convert	部隊重新檢查顯示器位置新視頻檔將轉換為 MCEBuddy
Monitor locations	監視器位置
Settings	設置
Select the file(s) in the queue to delete	刪除佇列中選擇的檔
Manually add video file(s) to the queue to convert	將視頻檔手動添加到要轉換的佇列
Start the MCEBuddy monitor and conversion tasks	開始 MCEBuddy 顯示器和轉換任務
Stop the MCEBuddy monitor and conversion tasks	停止 MCEBuddy 顯示器和轉換任務
There is a new version!	有新的版本 ！
High	高
Low	低
Priority	優先
High priority - convert faster but may make other running applications unresponsive\r\nLow priority - convert in the background but reduced interference with other running applications	高優先順序-轉換速度更快，但可能會使其他正在運行的應用程式 unresponsive\r\nLow 的優先事項-轉換背景但減少的干擾與其他正在運行的應用程式中
A task is a conversion template that contains a conversion profile and various other conversion parameters.\r\nEach file added to the queue will be processed and converted by each of these tasks.\r\nRefer to the MCEBuddy Guide for more details on how tasks work.	一項任務是轉換範本包含轉換設定檔和其他各種轉換 parameters.\r\nEach 將處理和轉換的這些任務是如何工作的詳細指南 MCEBuddy tasks.\r\nRefer 的每個檔添加到佇列中。
Getting started	入門
Click here for MCEBuddy guide	按一下此處查看 MCEBuddy 指南
Logs	日誌
Click to open log folder	按一下以打開日誌資料夾
MCEBuddy Status	MCEBuddy 狀態
add	添加
delete	刪除
paypal-donate	paypal-捐贈
stop	停止
OUTPUT: ConsoleOuput received NULL data	輸出： ConsoleOuput 收到 NULL 資料
hours	小時
minutes	分鐘
second	第二次
seconds	秒
Starting	開始
Comskip advertisement scan - Pass 1	Comskip 廣告掃描-傳遞 1
Comskip advertisement scan - Pass 2	Comskip 廣告掃描-傳遞 2
Cutting commercials from video	視頻切割的廣告
Cutting commercials from video - segment 	從視頻-切割廣告段
Merging commercial free segments into new video	將免費在商業部門合併到新視頻
Moving converted file to destination	將轉換後的檔移動到目標
Checking for disk space	檢查磁碟空間
Getting show information and banner from Internet sources	從互聯網來源獲取顯示資訊和橫幅
Copying source file to working directory	將原始檔案複製到工作目錄
Remuxing recording	Remuxing 錄製
ShowAnalyzer advertisement scan	ShowAnalyzer 廣告掃描
Comskip advertisement scan	Comskip 廣告掃描
Analyzing video information	視頻資訊分析
Converting	轉換
Removing commercials	刪除廣告
Writing show information	書面形式顯示的資訊
Renaming file using show information	使用顯示資訊的檔重命名
Success - All done!	成功-所有做過 ！
Muxing streams	隔木香流
Fallback remux	回退 remux
Correcting audio delay	糾正音訊延遲
Converting video file - Pass 1	轉換視頻檔-傳遞 1
Converting video file - Pass 2	轉換視頻檔-傳遞 2
Converting video file	將視頻檔轉換
Audio Track	音訊軌道
Impaired	受損
Channels	管道
Codec	轉碼器
Video	視頻
Duration	持續時間
Height	高度
Width	寬度
Audio	音訊
Name	名稱
Subtitle	副標題
Volume	卷
Enable custom file renaming	啟用自訂檔重命名
Enable this to enter a custom pattern to rename converted files and folders. Enter the custom pattern in the box below.\r\n\r\nExample:\r\nTVShows\%showname%\Season %season%\%showname% - S%season%##E%episode%## - %episodename% - %airyear%_%airmonth%_%airday%\r\n\r\nWill produce:\r\nTVShows\CSI\Season 1\CSI - S01E02 - Best of times - 2012_01_06.<ext>\r\n\r\nExample:\r\nRecording\%ismovie%<Movie\%showname%,TVShows\%showname%\Season %season%\%showname% - S%season%##E%episode%##>-Converted\r\n\r\nWill produce (for a movie)\r\n    Recording\Movies\Star Wars-Converted.<ext>\r\nOR (for non movies)\r\n    Recording\TVShows\CSI\Season 1\CSI - S01E02-Converted.<ext>\r\n\r\nRefer to the MCEBuddy advanced documentation for a list of all the pattern commands.	啟用此輸入轉換後的檔及資料夾重命名的自訂模式。輸入的自訂模式中框 below.\r\n\r\nExample:\r\nTVShows\%showname%\Season %season%\%showname%-S %季節 %##E %情節 # %#-%episodename%-%airyear%_%airmonth%_%airday%\r\n\r\nWill 製作： \r\nTVShows\CSI\Season 1\CSI-S01E02-最佳的時期-2012_01_06。<ext>\r\n\r\nExample:\r\nRecording\%ismovie%< Movie\%showname%,TVShows\%showname%\Season %season%\%showname%-S%season%##E%episode%##>-Converted\r\n\r\nWill (電影) 生產 \r\n Recording\Movies\Star 戰爭轉換。 <ext>（對於非電影) \r\nOR \r\n Recording\TVShows\CSI\Season 1\CSI-S01E02 轉換。MCEBuddy 到 <ext>\r\n\r\nRefer 高級模式的所有命令的清單檔。
ShowAnalyzer not found.\nPlease download and install ShowAnalyzer.	未找到 ShowAnalyzer。 \n 請下載並安裝 ShowAnalyzer。
ShowAnalyzer Missing	ShowAnalyzer 失蹤
Invalid language code, reverting to <Default> language	無效的語言代碼，恢復到 <Default>語言
Cut start	切的開始
Cut end	切端
This specifies the number of seconds to cut from the start of the recording (BEFORE removing the ads)	此選項指定要從一開始的錄音 （之前刪除廣告） 切的秒數
This specifies the number of seconds to cut from the end of the recording (BEFORE removing the ads)	此選項指定要削減從錄音結束的 （在刪除廣告） 之前的秒數
Send an eMail after each conversion.	每個轉換後發送電子郵件。
Send eMail	發送電子郵件
SMTP Server Name	SMTP 伺服器的名稱
Enter the outgoing eMail (SMTP) server address here\r\ne.g. smtp.gmail.com	輸入傳出電子郵件 (SMTP) 伺服器位址 here\r\ne.g。smtp.gmail.com
Port	埠
Enter the SMTP server port	輸入的 SMTP 伺服器埠
Use SSL	使用 SSL
Check this if you SMTP server uses SSL	如果您的 SMTP 伺服器使用 SSL，請
e-Mail Settings	電子郵件設定
From <e-Mail>	從 <e-Mail>
Enter the senders (From) eMail address here	（從） 的電子郵寄地址在這裡輸入寄件者
To <e-Mails>	到 <e-Mails>
Enter the recipients (To) eMail address here.\r\nSeparate multiple recipients with a semicolon (;)	輸入收件人 （到） 用分號 (;) 多個收件人的電子郵寄地址 here.\r\nSeparate
Send eMail on successful conversion	成功的轉換上發送電子郵件
Send eMail on failed conversion	發送郵件失敗的轉換
Send eMail on cancelled conversion	對已取消轉換發送電子郵件
Send eMail on adding a conversion to the queue	發送電子郵件上添加到佇列的轉換
Please enter a valid server address	請輸入一個有效的伺服器位址
Invalid SMTP Server	無效的 SMTP 伺服器
Please enter a valid server port	請輸入一個有效的伺服器埠
Invalid SMTP Port	SMTP 埠無效
Please enter a valid From eMail address	請輸入有效的電子郵寄地址
Invalid eMail Address	無效的電子郵寄地址
Please enter valid To eMail addresses	請輸入有效的電子郵寄地址
Username	使用者名
<Optional> Enter the username for the eMail server authentication	<Optional>輸入的電子郵件伺服器身份驗證的使用者名
<Optional> Enter the password for the eMail server authentication	<Optional>輸入的電子郵件伺服器身份驗證的密碼
MCEBuddy unable to download series information	MCEBuddy 無法下載系列資訊
MCEBuddy successfully converted a video	MCEBuddy 成功轉換視頻
Source Video	源視頻
Converted Video	轉換後的視頻
Converted At	在轉換
MCEBuddy failed to converted a video	MCEBuddy 視訊轉換失敗
Failed At	在失敗
MCEBuddy cancelled a video conversion	MCEBuddy 取消視訊轉換
Cancelled At	在取消
Working	工作
Test	測試
Testing	測試
Click this button to test the eMail server settings	按一下此按鈕可以測試電子郵件伺服器設置
MCEBuddy will send an eMail to test the server settings.\r\nThis can take upto 60 seconds.\r\nMCEBuddy may be unresponsive during this period.	MCEBuddy 將發送電子郵件到測試伺服器 settings.\r\nThis 可以採取至 60 多 seconds.\r\nMCEBuddy 可能沒有回應這一時期。
Test eMail	測試電子郵件
MCEBuddy Test eMail	MCEBuddy 測試電子郵件
MCEBuddy - Have a great day!	MCEBuddy-有偉大的一天 ！
Send eMail test successful	發送電子郵件測試成功
Send eMail test failed! Please check your settings and internet connectivity	發送電子郵件測試失敗 ！請檢查您的設置和互聯網連接
Test eMail Success	測試電子郵件成功
Test eMail Failed	測試電子郵件失敗
Send eMail on start of conversion	在轉換啟動發送電子郵件
MCEBuddy started a video conversion	MCEBuddy 開始視訊轉換
Conversion Started At	在開始轉換
Yes (Comskip)	是 （Comskip）
Yes (ShowAnalyzer)	是 （ShowAnalyzer）
Atleast one Conversion Task must be enabled	必須啟用至少一個轉換任務
Disable	禁用
Enable	啟用
Rename	重命名
Move	移動
Up	向上
Down	下來
Slow Remuxing	慢 Remuxing
Extracting closed captions	提取字幕
Validating closed captions	驗證關閉的字幕
Extracting subtitles	提取字幕
Trimming closed captions	修整關閉字幕
Extract subtitles and closed captions	提取字幕和關閉的字幕
Field	欄位
Channel	通道
Enable this to extract Closed Captions, Subtitles and Teletext from\r\nWTV, DVR-MS, TS, MP4, MKV and other supported files.\r\n\r\nIt is saved as a Subtitle (SRT) file.	啟用此提取關閉字幕，字幕和電傳視訊 from\r\nWTV、 DVR MS、 TS、 MP4、 MKV 和其他受支援的 files.\r\n\r\nIt 保存為字幕 （SRT） 的檔。
Enable this to set advanced options for Closed Captions extraction\r\nField - 1 or 2\r\nChannel - 1 or 2\r\n\r\nDefault: Field 1, Channel 1	啟用此設置關閉字幕 extraction\r\nField-1 或 2\r\nChannel-1 或 2\r\n\r\nDefault 的高級的選項: 欄位 1、 通道 1
Subtitle offset	副標題偏移量
Enter the number of seconds (+ve / -ve) to adjust the subtitles sync with video	輸入的秒數 (+ ve /-ve) 調整視頻的字幕同步
Re-ReMuxing due to audio error	Re ReMuxing 音訊錯誤
Save the poster and show information (metadata) in a MC/XBMC compatible NFO file (XML format)	保存這張海報，並在 MC/XBMC 相容的 NFO 檔 （XML 格式） 中顯示資訊 （中繼資料）
Check this box to save the show information (metadata) in the converted file.\r\nThis only works for files that support metadata tags like MP4, MKV, WTV etc.\r\n\r\nNOTE: Uncheck this box if you're facing issues with some devices such as older TV's which have problem reading metadata.	選中此框，將顯示資訊 （中繼資料） 保存轉換後的 file.\r\nThis 只支援元資料標記檔的工程如 MP4、 MKV、 WTV etc.\r\n\r\nNOTE： 如果你面對的問題與某些設備 （如舊電視有問題讀中繼資料，請取消選中此框。
Atleast one day of the week must be enabled	至少必須啟用一周的一天
Invalid Days of Week	周的無效天
Invalid day of week found in configuration file	在設定檔中找到的周中的日期無效
Scheduling	調度
Remuxing to	到 Remuxing
Part	部分
Rest your mouse on any button, box or item to get Instant Help on it.\n\nFor more information on how to use, troubleshoot or get support for MCEBuddy click on the <Getting Started> link on the top right corner.\n\nDonations are always welcome :) Enjoy!\n\n  - Ramit, Derek & Goose	其餘任何按鈕、 框或要獲取即時的説明，在 it.\n\nFor 上如何使用、 故障排除或者獲得對 MCEBuddy 的支援的詳細資訊項上的滑鼠按一下頂右 corner.\n\nDonations 的 < 入門 > 連結隨時歡迎您的:)享受! \n\n-Ramit、 德里克 & 鵝
Welcome to MCEBuddy	歡迎來到 MCEBuddy
Multichannel audio	多頻道音訊
Check to allow multi-channel audio if the source video supports it.\r\nBy default the audio is limited to 2 channels (stereo).	檢查允許多頻道音訊，如果源視頻支援 it.\r\nBy 預設音訊僅限於 2 通道 (身歷聲)。
Dynamic Range Compression (DRC)\r\nWhen the source is an AC3 audio, enabling DRC will\r\nreduce the difference between the loud and the soft\r\nsounds making the audio track more even.\r\nIf you have a multi-channel audio recording and you\r\nfeel the volume is too soft, checking this box might help.	動態範圍壓縮 （DRC） \r\nWhen 源是 AC3 音訊，使剛果民主共和國 will\r\nreduce 響亮和使您有一個多通道的音訊錄音和 you\r\nfeel 卷是太軟，檢查此框可能會説明更多 even.\r\nIf 的音訊軌道的 soft\r\nsounds 之間的差異。
FPS	新鮮糧食店
Logfile age (days)	日誌檔的時間 (天)
Maximum number of days to keep the logfiles before deleting them.\r\nSet to 0 to keep the logs forever.	要刪除 them.\r\nSet 為 0，以永遠保持日誌前保留日誌檔的天數的最大數目。
DVRMS Remuxing	DVRMS Remuxing
Fast Remuxing	快速 Remuxing
Byte stream remuxing	位元組流 remuxing
Disable cropping	禁用裁剪
Check this to disable cropping the video automatically during conversion.\r\nCropping is used to remove the "black bars" in the video (top, bottom, left or right).\r\nUse this option if the video picture is getting cut on any side or if the final picture is looking stretched or distorted.	檢查此要禁用在 conversion.\r\nCropping 期間自動裁剪視頻用於刪除"黑酒吧"的視頻 （頂部、 底部、 左邊或 right).\r\nUse 此選項如果視頻圖片獲取削減對任何一方或最後的圖片正在伸展或扭曲。
Only detect Ads	僅檢測到廣告
Check this if you want MCEBuddy to detect the ads (commercials) but NOT cut them from the video.\r\nWhen this option is enabled, MCEBuddy will create an EDL file along with the converted file that specifies the locations of ads in the converted video.\r\nAlso, for MP4, M4V and MKV files MCEBuddy will create Chapters to mark the end of commercials.	如果要 MCEBuddy 檢測 (廣告) 廣告但不是砍從啟用此選項的 video.\r\nWhen，MCEBuddy 將創建和轉換後的檔，轉換後的 video.\r\nAlso，在指定的位置的廣告，MP4，一部分為 EDL 檔和檔極東泵 MCEBuddy 將創建章節標記的廣告結束，請選中此處。
Download information	下載資訊
Correction	更正
Click here to correct the Show title and force use of a specific TVDB series id or IMDB movie id\r\nto lookup additional metadata from the internet.	按一下此處可正確顯示標題和從互聯網上強制使用特定的 TVDB 系列 id 或 IMDB 電影 id\r\nto 查找其他中繼資料。
Check this to download additional information from the internet about the show like a banner file, episode, season etc	檢查此從像一面旗幟檔、 插曲、 季節等節目在互聯網上下載的其他資訊
Profile Error	設定檔錯誤
Cannot find selected profile in profiles.conf	在 profiles.conf 中找不到所選的設定檔
Invalid Profile	不正確設定檔
Please select a valid profile	請選擇一個有效的設定檔
The MCEBuddy Engine has crashed. Please send mcebuddy.log to the developers	MCEBuddy 引擎已崩潰。請將 mcebuddy.log 發送給開發人員
Comskip INI	Comskip INI
Select the custom Comskip INI file to use for this conversion task\r\nLeave this blank to use the default Comskip INI file for advertisement removal	選擇要用於此轉換 task\r\nLeave 這個空廣告去除使用預設的 Comskip INI 檔的自訂 Comskip INI 檔
Click to select custom Comskip INI file	按一下以選擇自訂 Comskip INI 檔
Select the folder for working with temporary files. Make sure there is enough empty space on the drive.\r\nLeave this blank to use the default temp folder in the installation folder.	選擇使用暫存檔案的資料夾。請確保有足夠的空空間 drive.\r\nLeave 這個空以使用預設的 temp 資料夾中的安裝資料夾。
Select the folder for working with temporary files. Make sure there is enough empty space on the drive.\r\nThis overrides the temp folder specified in the Settings -> Expert Settings page.	選擇使用的暫存檔案的資料夾。請確保有足夠的空閒空間在 drive.\r\nThis 上重寫-> 專家設置版面設定中指定的暫存檔案夾。
Click to select temp working folder	按一下以選中臨時工作資料夾
Temp folder	暫存檔案夾
Space check	空間檢查
When enabled MCEBuddy will check for enough free space for the conversion (destination and temp).\r\nUncheck this if you have are having trouble with network drives or have extraordinarily large video files.	當啟用的 MCEBuddy 會檢查的足夠的空間存放轉換 （目的地和 temp).\r\nUncheck 這如果您也有麻煩與網路磁碟機或有特大的視頻檔。
MCEBuddy Windows Event Logs	MCEBuddy Windows 事件日誌
Events	事件
Click here to open the MCEBuddy Windows Event Logs	按一下此處打開 MCEBuddy Windows 事件日誌
Enable UPnP	啟用 UPnP
Check this to enable UPnP. This allows access to MCEBuddy engine from outside the network.\r\nThis needs to be checked if you're using a mobile/standalone MCEBuddy client to access MCEBuddy.	檢查以啟用 UPnP。這將允許訪問從外面 network.\r\nThis 的 MCEBuddy 引擎需要檢查是否您正使用移動/獨立的 MCEBuddy 用戶端存取 MCEBuddy。
Click here to connect to another MCEBuddy engine	按一下此處可連接到另一個 MCEBuddy 引擎
MCEBuddy Remote Engine Connection	MCEBuddy 遠端引擎連接
Engine Name	引擎名稱
Engine Port	引擎埠
Enter the Name or IP Address of the MCEBuddy engine you want to connect to	輸入的名稱或 IP 位址，您想要連接到的 MCEBuddy 引擎
Enter the TCP Port number of the MCEBuddy Engine you want to connect to	輸入您想要連接到的 MCEBuddy 引擎的 TCP 埠號
Enter the TCP Port number of the MCEBuddy Engine you want to connect to (1 to 63355)	輸入您想要連接到 （1 到 63355) 的 MCEBuddy 引擎的 TCP 埠號
Invalid Name/Port	每個埠無效名稱
Please enter a valid Engine Name and Engine Port Number	請輸入一個有效的引擎名稱和引擎埠號
Error Stopping Engine	錯誤停止引擎
Unable to stop MCEBuddy engine, settings may not be saved. Do you want to continue?	無法停止 MCEBuddy 引擎，可不保存設置。您要繼續嗎？
Unable to communicate with engine. Settings have NOT been saved.	無法與引擎進行通信。尚未保存的設置。
Communication Error	通信錯誤
Engine not stopped. Settings have NOT been saved.	不停的引擎。尚未保存的設置。
Unable To Save Settings	無法保存設置
Unable to communicate with engine. UPnP settings have not been updated	無法與引擎進行通信。UPnP 設置未更新
Audio delay	音訊延遲
Enter a value in seconds (positive or negative) here to shift the audio relative to the video.\r\nUse this to resync the audio with the video, if they are out of sync after conversion.\r\nA positive value will delay the audio (i.e. video ahead of audio) and a negative value will advanced the audio (i.e. audio ahead of video).\r\nE.g. -1.5	輸入一個值，以秒為單位 （正數或負數） 在這裡轉變與 video.\r\nUse 音訊這要重新同步的音訊與視頻，如果他們是同步後 conversion.\r\nA 正值將延遲 （即前音訊視頻） 音訊和負值將先進的音訊 （即前 video).\r\nE.g 音訊。-1.5
Media info	媒體資訊
Click here to get media properties for selected files	按一下此處獲取所選檔的介質屬性
Save information	保存資訊
Add information	添加資訊
Shows a preview of the custom filename and path	顯示自訂檔案名和路徑的預覽
Invalid Filename Pattern	不正確檔案名模式
TVDB Series ID	TVDB 系列 ID
IMDB Series ID	IMDB 系列 ID
Original title	原始的標題
Corrected title	更正的標題
Enter the TVDB Series ID you want to use for downloading show information.\r\nIf the Original title box is empty, this will be applied to all shows selected by this conversion task.	輸入您想要使用下載顯示使用的 TVDB 系列 ID information.\r\nIf 原標題框是空的這將應用到選定的這一轉換任務的所有節目。
Enter the IMDB Movie ID you want to use for downloading movie information.\r\nIf the Original title box is empty, this will be applied to all shows selected by this conversion task.	請輸入您想要使用下載電影 information.\r\nIf 原來使用的 IMDB 電影 ID 標題框為空，這將應用到選定的這一轉換任務的所有節目。
Internet Lookup Title and Metadata Correction	互聯網查找標題和中繼資料校正
Click here to add another row to match and correct titles and series id.\r\nIf you want to use the same corrected title or series id for all shows converted by this conversion task,\r\nleave the original title blank on the first row and you should NOT add a second row.	按一下此處可添加另一行來匹配和正確的標題和您想要使用的已更正的標題相同或系列 id 為通過此轉換任務轉換的所有節目系列 id.\r\nIf \r\nleave 原標題為空第一次行和你應該不添加第二行。
Enter pattern to match show/series titles for correction (e.g. Simpson* will replace all titles that have a show title starting with Simpson)\r\nPrefix pattern with ~ to skip the match (e.g. *.*;~Simpson* will correct all show titles except those that start with Simpson)\r\nSeparate multiple patterns with ; (e.g. Simpson*;House*) or (e.g. Simpson*;NCIS*;~NCIS Miami*)\r\n\r\nNOTE: Leave this box empty if you want to apply the corrected title or series id to ALL files being processed by this conversion task.\r\nIf leaving blank, you cannot add a second row.\r\n\r\nYou can use a regular expression to match the title by starting with regex:	輸入要匹配顯示/系列標題的更正 （例如辛普森 * 將取代已開始與辛普森顯示標題的所有書名） 模式 \r\nPrefix 模式與 ~ 要跳過這場比賽 （例如 *。 * ； ~ 辛普森 * 將更正所有顯示標題，開始與辛普森的除外） \r\nSeparate 多模式 ；(例如辛普森 * ；House*） 或 （例如辛普森 * ；NCIS*; ~ 海軍罪案調查處邁阿密 *) \r\n\r\nNOTE： 將此框保留為空如果你想要應用於正在處理的空白此轉換 task.\r\nIf 的所有檔的更正的標題或系列 id，您不能添加第二個 row.\r\n\r\nYou 可以使用正則運算式來匹配標題入手 RegEx:
Enter the new/corrected title you want to use for downloading additional information from the internet.\r\nIf the Original title box is empty, this will be applied to all shows selected by this conversion task.\r\n\r\nYou can use a regular expression to correct the title by starting with regex:	請輸入您想要使用下載的附加資訊使用新/更正的標題從原始 internet.\r\nIf 標題框為空，這將應用到選定的這種轉換的所有顯示 task.\r\n\r\nYou 可以使用正則運算式通過正則運算式從開始更正標題：
For each row, please enter the Original title to match the show name AND either a Corrected title or a TVDB/IMDB Series ID	對於每一行，請輸入要匹配的顯示名稱和任一經更正原始標題標題或 TVDB/IMDB 系列 ID
Please enter either a Corrected title or a TVDB/IMDB Series ID	請輸入一個經更正標題或 TVDB/IMDB 系列 ID
Enable this if you want MCEBuddy to put the converted file in the source directory\r\nif the destination path is unavailable. (e.g. Network failure or mapping failure)	如果您想把已轉換的 MCEBuddy 啟用此源 directory\r\nif 的目標路徑中的檔將不可用。（如網路或映射發生故障）
Fallback to source path	回退到源路徑
Used to increase or decrease the volume of the\r\nrecording while converting.\r\n1 is normal, anything below will reduce it, anything\r\nhigher will increase it.	用來增加或減少量的 the\r\nrecording，而 converting.\r\n1 是正常的任何東西下面將減少它，anything\r\nhigher 會增加它。
Archive folder	存檔資料夾
Change the location of the archive folder.\r\nLeave empty to use the default 'MCEBuddyArchive' folder in the original directory.	更改存檔 folder.\r\nLeave 為空以使用預設的原始目錄中的 'MCEBuddyArchive' 資料夾的位置。
Monitor subdirectories	監視器子目錄
Check this box to also monitor all directories within the Monitor path	選中此核取方塊，還監測監控路徑內的所有目錄
Click here to show MCEBuddy status	按一下此處顯示 MCEBuddy 狀態
MCEBuddy service not connected	不連接的 MCEBuddy 服務
MCEBuddy idle	MCEBuddy 空閒
conversions in progress	進展中的轉換
MCEBuddy stopped	MCEBuddy 已停止
Sync converted files	將轉換後的檔同步
Check this option if you want MCEBuddy to keep the converted files in sync with the original files.\r\ni.e. When the original files are deleted by the user, the corresponding converted files are also deleted.\r\n\r\nNOTE: MCEBuddy only monitors original files in the monitor locations folders and ONLY while the engine is running.\r\nMCEBuddy will not be able to track user deleted files while the engine is stopped.	如果您想保持轉換後的檔同步與原始的 files.\r\ni.e 的 MCEBuddy，請選中此選項。當使用者刪除原始檔案，則相應轉換後的檔也是 deleted.\r\n\r\nNOTE： MCEBuddy 只監視監視器位置資料夾中的原始檔案，並只雖然發動機是 running.\r\nMCEBuddy 將不能夠跟蹤使用者已刪除的檔，而該引擎已停止。
Do you wish MCEBuddy to delete each converted file when the original file has been deleted?	您是否要刪除每個已轉換的檔時的原始檔案已被刪除的 MCEBuddy?
Confirm sync conversions?	確認同步轉換嗎？
Are you sure you DO NOT want to remove commercials from the converted video and only keep the EDL file?	確實不做您想要刪除廣告從轉換後的視頻，只保留 EDL 檔嗎?
ShowAnalyzer is not responding. Please the reboot system or reinstall ShowAnalyzer.	ShowAnalyzer 沒有回應。請重新開機系統，或者重新安裝 ShowAnalyzer。
ShowAnalyzer Not Responding	ShowAnalyzer 沒有回應
Make sure you press 'Start' after closing this window, otherwise Scheduling and Wake will not work.	請確保您按 '開始' 關閉此視窗後，否則計畫和喚醒將不工作。
Enabling Scheduling and Wake	有利調度和喚醒
Passwords do not match	密碼不匹配
Password error	密碼錯誤
Adding subtitles and chapters to file	向檔中添加字幕和章節
Send eMail if unable to download series information	如果無法下載系列資訊，發送電子郵件
Check this box if you want this conversion task to only process files from specific monitor locations.\r\nIf unchecked each conversion task will process files from all monitor locations (including new ones added later).	如果您希望此轉換任務僅處理特定監視器 locations.\r\nIf 未選中每個轉換任務將進程從所有監視器位置 （包括以後添加新的） 檔中的檔，請選中此框。
Select Monitor Locations	選擇顯示器位置。
Select atleast one Monitor Location name	選擇至少一個監視器位置名稱
You have selected all the current Monitor Locations.\r\nDo you want this conversion task to automatically process any new Monitor Locations added in future?	您選擇了您希望自動處理在將來添加任何新的監視器位置此轉換任務的所有當前的監視器 Locations.\r\nDo 嗎？
New monitor locations	新的監視器位置
Invalid selection	不正確選擇
Channel name match	通道名稱匹配
Enter pattern to match the channel name for this task (e.g. ABC* will convert all files that recorded on a channel name starting with ABC)\r\nPrefix pattern with ~ to skip the match (e.g. *;~ABC* will process all channels except those that start with ABC)\r\nSeparate multiple patterns with ; (e.g. ABC*;TBS*) or (e.g. ABC*;Fox*;~Fox4*)\r\n\r\nYou can use regular expressions to match the pattern by starting with regex:	輸入要匹配此任務 (例如 ABC * 將轉換記錄在 ABC 從開始的通道名稱的所有檔) 的通道名稱模式 \r\nPrefix 模式與 ~ 要跳過這場比賽 （例如 * ； ~ ABC * 將處理所有管道，以 ABC 開頭的除外） \r\nSeparate 多模式 ；(例如 ABC * ；TBS*） 或 （例如 ABC * ；Fox*; ~ Fox4 *) \r\n\r\nYou 可以使用正則運算式與模式匹配的正則運算式從開始：
Clear history	清除歷史記錄
Click this button to clear the history of all converted files.\r\nThis is cause MCEBuddy to reconvert all files being monitored.	按一下此按鈕以清除歷史記錄的所有轉換後的 files.\r\nThis 是導致 MCEBuddy 以重組正在監視的所有檔。
Are you sure you want to clear the history of all conversions?\r\nThis will cause MCEBuddy to reconvert all files being monitored.	是否確實要清除所有轉換的歷史呢？ \r\nThis 將導致 MCEBuddy 以重組正在監視的所有檔。
Show history	顯示歷史記錄
Click this button to show the history of all converted files.	按一下此按鈕可顯示所有已轉換檔的歷史記錄。
History of Converted Files	轉換後的檔的歷史記錄
Unable to communicate with engine.	無法與引擎進行通信。
Extracting streams	提取流
Fallback muxing streams	回退灸法流
Remuxing TiVO file	Remuxing TiVO 檔
Enter your 10 digit TiVO MAK key to convert and process TiVO recordings	請輸入您的 10 位 TiVO 麥鍵轉換和處理 TiVO 錄製
Invalid TiVO MAK Key	不正確 TiVO MAK 金鑰
The TiVO MAK key should be 10 digits	TiVO MAK 金鑰應該為 10 位數位
Version mismatch. Please ensure that the MCEBuddy client and engine are running the same version.	版本不匹配。請確保在 MCEBuddy 用戶端和引擎都運行相同的版本。
Error retrieving Event Logs	檢索事件日誌時出錯
Unable to get Event Log Entries from the MCEBuddy engine.	無法獲得事件日誌條目從 MCEBuddy 引擎。
PAUSED: Check conversion schedule	已暫停： 檢查轉換計畫
Logging	日誌記錄
Folder Management	資料夾管理
Processor Management	處理器管理
Expert Settings	專家設置
System Settings	系統設置
Click here to change additional settings (for experts only)	按一下此處以更改其他設置 （僅供專家)
Failed folder	失敗的資料夾
Location of the folder that hold the original files for failed conversions.	存放轉換失敗的原始檔案的資料夾的位置。
Move original file on failure	移動上失敗的原始檔案
Check this to move the original file to a separate folder if the conversion fails.	對此進行檢查將原始檔案移動到一個單獨的資料夾，如果轉換失敗。
Check this to limit the number of logical processors that MCEBuddycan use.\r\nEach check box below corresponds to an available logical processor.	對此進行檢查下面的 MCEBuddycan use.\r\nEach 核取方塊對應于可用的邏輯處理器的邏輯處理器的數目限制。
Each box represents logical processors from 1 to 16 respectively.\r\nChecking a box allows MCEBuddy to use that processor.	每個框表示邏輯處理器從 1 到 16 respectively.\r\nChecking 框中允許使用該處理器的 MCEBuddy。
Each box represents logical processors from 17 to 32 respectively.\r\nChecking a box allows MCEBuddy to use that processor.	每個框表示邏輯處理器從 17 至 32 respectively.\r\nChecking 框中允許使用該處理器的 MCEBuddy。
Select atleast one processor to use	選擇至少一個處理器使用
Invalid Configuration	不正確配置
Comskip path	Comskip 路徑
If you want to use a custom version of Comkip (e.g. donator version)\r\nthen enter the path of the comskip installation here.\r\nLeave blank to use the default comskip that comes with MCEBuddy.	如果您想要使用一個自訂版本的 Comkip (例如捐贈版) \r\nthen 輸入的 comskip 安裝 here.\r\nLeave 留空，使用帶有 MCEBuddy 的預設 comskip 的路徑。
Miscellaneous	雜項
Ignore copy protection	忽略禁止複製
Check this to ignore the copy protection flag on video file while converting.\r\nNOTE: MCEBuddy cannot bypass encryption, this only helps if a file is incorrectly\r\ntagged as copy protected when it is NOT encrypted.	請檢查此項以忽略時 converting.\r\nNOTE 的視頻檔的禁止複製標誌： MCEBuddy 不能繞過加密，這只可以説明如果一個檔是 incorrectly\r\ntagged 作為禁止複製時未加密。
Use recycle bin	使用回收站
Check this to use the recycle bin when files are deleted by MCEBuddy	請檢查此項可使用回收站，當檔被刪除的 MCEBuddy
Poll period	投票期間
This is how often MCEBuddy scans the Monitor Tasks Locations for new files.\r\nThe interval is specified in seconds.	這是如何往往 MCEBuddy 掃描監視器任務位置以秒為單位指定新的 files.\r\nThe 間隔。
Server port	伺服器埠
This is the TCP port MCEBuddy uses to communicate with the remote engine.\r\nWhen UPnP is enabled, MCEBuddy will automatically add this port to the Windows Firewall\r\nand UPnP gateway to allow access from the internet on this port.	這是 MCEBuddy 使用與進行通信啟用 UPnP，則遠端 engine.\r\nWhen MCEBuddy 將自動添加到 Windows Firewall\r\nand UPnP 閘道，允許從這個埠上互聯網訪問此埠的 TCP 埠。
Hang period	期內坑
Enter the number of seconds that MCEBuddy will wait for a response from the\r\nunderlying application before terminates the application as hung.\r\nEnter 0 to disable hang detection.	輸入的 MCEBuddy 將等待從 the\r\nunderlying 的應用程式的回應的秒數之前終止應用程式作為 hung.\r\nEnter 0 來禁用掛起檢測。
Subtitle commercial cut sync	副標題商業剪同步
This parameter is used when the subtitles go progressively out of sync after each commercial segment is removed from the video.\r\nThis setting is used to bring the subtitles back into sync with the video.\r\nEach time the video commercial is cut out, the subtitles are time shifted by this amount (+ve or -ve in seconds).	轉到逐步同步每個商業段從 video.\r\nThis 設置刪除後用來帶字幕的字幕回與商業視頻切出的 video.\r\nEach 時間同步時使用此參數，字幕是由這個數額 （+ ve 或-ve 以秒為單位） 轉移的時間。
Invalid poll period	無效投票期
Invalid server port	不正確伺服器埠
eMail Subject Customization	主題自訂的電子郵件
Use this section to customize the subject of eMail sent by MCEBuddy on the various conversion events listed below.\r\nRefer to the documentation, custom commands for user defined variables.\r\ne.g. Show %showname% for file %originalfilename% conversion successful using task %taskname%\r\nNOTE: Not always will all the data be available in the custom commands.\r\nLeave blank to use default subject lines.	此節可自訂電子郵件的主題發送的 MCEBuddy 上使用各種轉換事件列出 below.\r\nRefer 的文檔，使用者定義 variables.\r\ne.g 的自訂命令。顯示成功使用任務 %taskname%\r\nnote%showname %檔 %originalfilename%改為： 所有的資料並不總是會在自訂的 commands.\r\nLeave 為空以使用預設的主題行中可用。
Success	成功
Failed	失敗
Cancelled	取消
Download fail	下載失敗
Limit processor utilization	限制處理器利用率
Check this to limit the number of logical processors that MCEBuddy can use.\r\nEach check box below corresponds to an available logical processor.	請檢查這限制的 MCEBuddy 可以 use.\r\nEach 核取方塊下面的邏輯處理器數對應于可用的邏輯處理器。
Custom profile	自訂設定檔
If you have a custom profiles.conf file that you want to use instead of the\r\none that comes with MCEBuddy, enter the path to the file here.\r\n\r\nNOTE: MCEBuddy constantly updates profiles.conf to provide bug fixes,\r\nenhancements and performance improvements which you will miss out\r\non if you use this feature.	如果您有一個自訂的 profiles.conf 檔，您想要使用而不是來與 MCEBuddy 的 the\r\none，輸入檔 here.\r\n\r\nNOTE 的路徑： MCEBuddy 不斷更新 profiles.conf 提供 bug 修復、 \r\nenhancements 和性能方面的改進，你將會錯過 out\r\non，如果您使用此功能。
Invalid custom profiles.conf	不正確自訂 profiles.conf
Suspend on battery	在電池上暫停
Suspend conversions when the computer switches to battery power	當電腦切換到電池電源時暫停轉換
MCEBuddy added a video conversion to the queue	MCEBuddy 添加到佇列的視訊轉換
Queue	佇列
Refer to documentation on using custom commands in custom eMail subjects	關於使用自訂的電子郵件主題中的自訂命令檔，請參閱
Could not copy information to Clipboard, please try again.	無法將資訊複製到剪貼簿，請再試一次。
Error copying to Clipboard	複製到剪貼簿時出錯
Copy to clipboard	複製到剪貼簿
Reconvert files	漢字重選的檔
Are you sure you want to reconvert the selected files?	你確定你要重新轉換選定的檔？
Select the files you want to reconvert and then click this button.\r\nIf the original files are still being monitored by MCEBuddy they will be queued for reconversion.	選擇您想要重新轉換，然後按一下此原始檔案仍正在監測由他們將排隊進行漢字重選的 MCEBuddy 的 button.\r\nIf 的檔。
Time taken to convert	轉換所需的時間
Network authentication	網路身份驗證
Click the button to enter the network shares credentials.\r\nThis authentication is used when files are added via the Add button on the main window\r\nor dragged and dropped from a network share into the conversion status box on the main window.	按一下按鈕，進入網路共用 credentials.\r\nThis 身份驗證使用通過主要的 window\r\nor 上的添加按鈕添加檔時拖動，從網路共用放到主視窗上的轉換狀態框。
Skip reconversion	跳過漢字重選
Do not reconvert the video if a converted file already exists in the destination directory.	如果轉換後的檔已經存在，目標目錄中不重組視頻。
The expected filename for the converted video (not the original video filename) is compared with the filenames in the destination directory.\r\nIf the converted file exists, the file will not be reconverted and it will be assumed to be a successful conversion.\r\nThis is useful if the same show/episode is being recorded on multiple times and you don't want to reconvert them.\r\n\r\nNOTE: This option is ignored for videos that are added manually using the add button or dragging and dropping	預期的檔案名為轉換後的視頻 （不原始視頻檔案名） 相比轉換後的檔存在的目的地 directory.\r\nIf 中的檔案名，該檔將不復原和它會被認為是成功的 conversion.\r\nThis 很有用如果同樣的顯示事件正在錄製上多次，你不想以重組 them.\r\n\r\nNOTE： 此選項將被忽略為手動使用添加按鈕或拖動和刪除添加的視頻
If enabled, skip reconversion will also check the history file for past conversions.\r\nThe expected filename for the converted video (not the original video filename) is compared with the filenames in the history file.\r\nIf the to be converted filename (including path) matches any of the already converted filenames (including paths) in the history file,\r\nthe file will not be reconverted and it will be assumed to be a successful conversion.	如果啟用了，跳過漢字重組還會檢查歷史記錄檔為過去 conversions.\r\nThe 預期檔案名轉換後視頻 （不原始視頻檔案名） 的，相比歷史 file.\r\nIf 中的檔案名，將轉換後的檔案名 （包括路徑） 匹配任何歷史檔中的已轉換檔案名 （包括路徑）、 \r\nthe 檔將不復原和它將被認為是成功的轉換。
Adding file to the iTunes library	將檔添加到 iTunes 資料庫
Add to iTunes	添加到 iTunes
Check this box to automatically add the converted files to the iTunes library.\r\nThis only works with iTunes supported files (e.g. MP4, M4V, MP3 etc)	複選此框，將轉換後的檔自動添加到 iTunes library.\r\nThis 只適用于 iTunes 支援檔 （如 MP4、 一部分、 MP3 等）
Adding file to the WMP library	將檔添加到 WMP 庫
Library Management	圖書館管理
Add to Windows Media Player	添加到 Windows 媒體播放機
Check this box to automatically add the converted files to the WMP library.	選中此核取方塊以將轉換後的檔自動添加到 WMP 庫。
Renaming and Sorting	重命名和分類
Selection Filters	選擇篩檢程式
Audio and Video	音訊和視頻
Subtitles and Chapters	字幕和章節
Skip copying original files	跳過將原始檔案複製
CHECK THIS BOX AT YOUR OWN RISK.\r\nDO NOT CHECK THIS BOX UNLESS YOU KNOW WHAT YOU ARE DOING.\r\nCheck this box to skip making a backup of original file (copying) while converting.	請檢查此框在您自己 RISK.\r\nDO 不檢查此框除非你知道你是什麼 DOING.\r\nCheck 此框將轉換時跳過製作的 （複製） 的原始檔案的備份。
CHECK THIS BOX AT YOUR OWN RISK.\r\nDO NOT CHECK THIS BOX UNLESS YOU KNOW WHAT YOU ARE DOING.\r\nCheck this box to skip making a backup of original file (copying) while converting.\r\nIf this is checked, the original file will not be preserved in case of an error.\r\nIt can also even lead to conversion failures or other unforeseen conversion issues.	請檢查此框在您自己 RISK.\r\nDO 不復選此框除非你知道你是選中此框可跳過這同時 converting.\r\nIf 製作的 （複製） 的原始檔案的備份，在 error.\r\nIt 的情況下，不會保留原始檔案的 DOING.\r\nCheck 可以還甚至導致轉換失敗或其他不可預見的轉換問題。
Are you sure you want to do this?	你確定你要這樣做？
Media Information Management	媒體資訊管理
Force show type	部隊放映類型
Set this to force treating the video recording as a Movie or TV Series.\r\nThis will change the way additional information (metadata) about the recording is downloaded from the internet.\r\nMovie - Treat the recording as movie\r\nSeries - Treat the recording as a TV Series\r\nSports - Treat the recording as a Sports show\r\nDefault - Use the default information available in the recording metadata to determine Movie or TV Series	設置此強制治療，錄影作為一部電影或電視 Series.\r\nThis 將改變有關記錄的其他資訊 （中繼資料） 從 internet.\r\nMovie 下載-治療作為 movie\r\nSeries-治療作為電視 Series\r\nSports 錄製錄音-治療的方式作為體育 show\r\nDefault-使用預設可用記錄中繼資料中的資訊來確定電影或電視系列節目錄製
Show type	顯示類型
Select this to filter the type of recordings being converted.\r\n\r\nMovies - select this to convert if the show type is Movie.\r\nShows - select this to convert if the show type is NOT a Movie.\r\nSports - select this to convert if the show type is Sports.\r\n\r\nNOTE: Show type is read from the recording metadata.\r\nOnly some recordings support show type metadata such as WTV and\r\nrecordings with supporting metadata files (XML/ARG etc).	選擇此選項可篩選的錄音被 converted.\r\n\r\nMovies 的類型-選擇此選項以轉換如果顯示類型是 Movie.\r\nShows-選擇此選項以轉換如果顯示類型不是 Movie.\r\nSports-選擇此選項以轉換如果顯示類型是 Sports.\r\n\r\nNOTE： 顯示類型從一些錄音支援錄製 metadata.\r\nOnly 中讀取顯示類型中繼資料如沃普特 and\r\nrecordings 與支援元資料檔案 （XML/ARG 等)。
This box shows all the files in queue for conversion.\r\nDrag and drop files here or press the Add button to add files to the conversion queue	此框中顯示的所有檔中的 conversion.\r\nDrag 和拖放檔在這裡或按添加按鈕，將檔添加到轉換佇列的佇列
Conversion	轉換
Files	檔
Click this button to open or close the Advanced Settings section	按一下此按鈕可打開或關閉高級設置部分
Running custom commands	運行自訂命令
Trimming video recording	修剪視頻錄製
Insert at top of queue	在佇列的頂部插入
By default, new conversions are added to the bottom (end) of the conversion queue.\r\nIf this box is checked, any new conversions added by this task will be added to the\r\nbeginning (top) of the conversion queue.	預設情況下，新的轉換添加到選中此框，此任務由添加的任何新的轉換將添加到 the\r\nbeginning （頂部） 的轉換佇列轉換 queue.\r\nIf 的底部 （結束）。
Add subtitles and chapters	添加字幕和章節
Enable this option to add any extracted subtitles and chapters to the converted video.\r\nEach chapter marks the end of a commercial. This only works with supported formats (e.g. MKV, MP4).\r\n\r\nNOTE: Some players and older TV's don't support embedded subtitles and chapters.\r\nIf you're unable to playback the converted video's, try turning this option off.	啟用此選項可添加任何提取的字幕和到轉換後的 video.\r\nEach 章章標誌著一個商業的結束。這只適用于支援的格式 （例如 MKV、 MP4).\r\n\r\nNOTE： 有些球員和舊電視不支援嵌入式的字幕和 chapters.\r\nIf 你找不到播放的轉換後的視頻，請嘗試關閉此選項。
Select best soundtrack	選擇最佳電影配樂
If the original video has multiple soundtracks, this option tells MCEBuddy to select the most appropriate and primary soundtrack.\r\nIf you want a specific language soundtrack, make sure you enter the language name or code in the Audio Language box.\r\nCheck this box if you're hearing the wrong soundtrack in your converted file.\r\n\r\nUncheck this box if you want MCEBuddy to retain all the soundtracks from the original video in the converted file when possible.\r\nNOTE:Some profiles do not support multiple soundtracks, in which case this setting has no effect.	如果原始視頻有多個原聲的此選項將告訴 MCEBuddy 選擇你想要的特定語言電影配樂的最適當和最初級的 soundtrack.\r\nIf，請確保您輸入的語言名稱或代碼在音訊語言 box.\r\nCheck 此框，如果你聽錯了電影配樂中您轉換後的 file.\r\n\r\nUncheck 此框如果您希望保留原始視頻在轉換後的檔時可能從所有原聲音樂的 MCEBuddy.\r\nNOTE: 某些設定檔不支援多個電影配樂，在這種情況下此設置不起作用。
Enable remote access	啟用遠端存取
This creates an exception in the windows firewall for MCEBuddy application and the port.\r\nThis is required if you have windows firewall enabled and want to use UPnP, the remote client\r\nor access the engine using an IP address.\r\n\r\nNOTE: If you have a custom firewall, this may not work, you will need to manually create an\r\nexception for MCEBuddy service and the port.	這在 windows 防火牆中為 MCEBuddy 應用程式創建的異常，如果您已啟用 windows 防火牆並且想要使用 UPnP，遠端 client\r\nor 訪問引擎使用 IP address.\r\n\r\nNOTE port.\r\nThis 則需要： 如果你有一個自訂防火牆，這可能不工作，您將需要手動創建 an\r\nexception MCEBuddy 服務和埠。
Unable to communicate with engine. Firewall exception settings have not been updated.	無法與引擎進行通信。不更新了防火牆例外設置。
Detect and optimize video quality	檢測和優化的視頻品質
When enabled, MCEBuddy will optimize the video processing options by trying to detect the video source type.\r\nThis can improve the quality of the converted video significantly if correctly detected.\r\n\r\nNOTE: It does this by trying to detect the video source type (interlaced, progressive or telecine).\r\nIf it is able to detect the video source type, it will override the corresponding parameters in the profile.\r\nTurn this option off if you are facing issues with converted video quality or want to use the default profile parameters.	啟用時，MCEBuddy 將嘗試檢測視頻源 type.\r\nThis 可以顯著改善的轉換後的視頻品質，如果正確地通過優化的視頻處理選項 detected.\r\n\r\nNOTE： 這是通過嘗試檢測的視頻源類型 （隔行掃描，進步或 telecine).\r\nIf 它是能夠檢測到視頻源類型它將重寫此選項關閉，如果你正面臨問題，轉換後的視頻品質，或者想要使用的預設設定檔參數 profile.\r\nTurn 中的相應參數。
Are you sure you want to delete this task?	是否確實要刪除此任務?
Delete Task	刪除任務
Enter the new task name	輸入新任務名稱
Rename Task	重命名任務
MCEBuddy PAUSED	MCEBuddy 已暫停
idle	空閒
PAUSED	暫停
Frame rate	畫面播放速率
Enable this to set a custom framerate (FPS) for the converted video.\r\nYou may need to set this while converting video formats (e.g. PAL to NTSC)\r\nor for devices which support only specific framerates.\r\n\r\nE.g.: 25\r\nE.g.: 30000/1001	啟用此設置自訂的畫面播放速率 (FPS) 為轉換後的 video.\r\nYou 可能需要設置此轉換視頻格式 (例如對 NTSC PAL) \r\nor 的設備的支援時: 25\r\nE.g.: 30000/1001年僅特定 framerates.\r\n\r\nE.g。
Skip remuxing files	跳過 remuxing 的檔
CHECK THIS BOX AT YOUR OWN RISK.\r\nDO NOT CHECK THIS BOX UNLESS YOU KNOW WHAT YOU ARE DOING.\r\nCheck this box to skip remuxing the original file to a TS file while converting.\r\nIf this is checked, some functions like subtitle extraction or comskip may not work.\r\nIt can also even lead to conversion failures or other unforeseen conversion issues.	請檢查此框在您自己 RISK.\r\nDO 不復選此框除非你知道你想要什麼 DOING.\r\nCheck 此框跳到 TS 檔同時選中此選項的 converting.\r\nIf 的 remuxing 的原始檔案、 像字幕提取或 comskip 的某些功能可能不 work.\r\nIt 可以還甚至導致轉換失敗或其他不可預見的轉換問題。
CHECK THIS BOX AT YOUR OWN RISK.\r\nDO NOT CHECK THIS BOX UNLESS YOU KNOW WHAT YOU ARE DOING.\r\nCheck this box to skip remuxing the original file to a TS file while converting.	請檢查此框在您自己 RISK.\r\nDO 不檢查此框除非你知道你是什麼 DOING.\r\nCheck 此框跳到 TS 檔在轉換時的 remuxing 的原始檔案。
Monitor converted videos	監測轉換的視頻
By default Monitor Locations will ignore files that have already been converted.\r\nCheck this box if you also want to monitor converted files in the Monitor Path.\r\nCAUTION: This can lead to an infinite conversion loop of converted files if not configured properly.\r\n\r\nThis can be useful when you are specifying the output directory of a conversion task\r\n(converted file) as the Monitor Path of a Monitor Location and linking the\r\nMonitor Location to another conversion task.	預設情況下監視器位置將忽略檔已經被 converted.\r\nCheck 此框如果你還想要監視在監視器 Path.\r\nCAUTION 轉換後的檔： 這可能會導致轉換後的檔無限轉換迴圈，如果不是你是作為監視器顯示器位置的路徑指定的輸出目錄的轉換 task\r\n （轉換後的檔） 和連結 the\r\nMonitor 時，配置的 properly.\r\n\r\nThis 可以很有用到另一個轉換任務的位置。
CHECK THIS BOX AT YOUR OWN RISK.\r\nDO NOT CHECK THIS BOX UNLESS YOU KNOW WHAT YOU ARE DOING.\r\nBy default Monitor Locations will ignore files that have already been converted.\r\nCheck this box if you also want to monitor converted files in the Monitor Path.	檢查此框在您自己 RISK.\r\nDO 不檢查此框除非你知道你是什麼 DOING.\r\nBy 預設監視器位置將忽略檔已經被 converted.\r\nCheck 此框，如果你還想要監視的監視器路徑中轉換後的檔。
Hardware encoding	硬體編碼
Check this box to use hardware encoding when available to convert videos.\r\nThis can speed up the conversion significantly and reduce the CPU utilization\r\nbut it can result in slightly lower quality videos.\r\n\r\nUncheck this box if you're facing conversion or quality issues.	請檢查此框可以使用硬體編碼時可用來轉換 videos.\r\nThis 可以大大加快轉換和減少 CPU utilization\r\nbut 它可以導致稍低品質 videos.\r\n\r\nUncheck 這框如果你面對的轉換或品質問題。
Do not overwrite files	不會覆蓋檔
When this box is checked, the destination file will not be overwritten if it already exists.\r\nInstead a new file will be created with a unique number added to the end of the filename.	選中此框後，如果它已經使用一個唯一的編號將創建的 exists.\r\nInstead 一個新檔添加到檔案名的末尾不會覆蓋目的檔案。
Re-monitor recorded videos	重新監視錄製的視頻
By default, once a source file (Recorded video) has been converted,\r\nthe monitor history will track the filename and not queue the same files again.\r\n\r\nEnable this option to ignore the history and monitor all files and add them to\r\nthe conversion queue, even if they have already been converted.\r\n\r\nThis can be useful sometimes, if the recording software does not generate a\r\nunique filename for each episode/show. It is reccomended to use the\r\nDelete original file option in the Settings page when using this option to avoid\r\nan infinite conversion loop.	預設情況下，一旦已轉換原始檔案 （視頻記錄），\r\nthe 顯示器歷史將跟蹤的檔案名和不相同的檔 again.\r\n\r\nEnable 佇列此選項可忽略歷史和監測所有檔並將它們添加 to\r\nthe 轉換佇列，即使他們已經過有時可有用 converted.\r\n\r\nThis如果燒錄軟體不會生成 a\r\nunique 檔案名為每個的一集節目。它是建議 the\r\nDelete 原始檔案選項在設置頁中使用時要使用此選項可 avoid\r\nan 無限轉換迴圈。
Recommendation	建議
To avoid an infinite conversion loop, it is recommended to setup your Monitor search pattern in a way such as to ensure that the converted files are not being monitored by this Monitor task.	為了避免無限轉換迴圈，它被建議安裝方式如您顯示器的搜索模式，確保轉換後的檔不被此監視器任務進行監測。
CHECK THIS BOX AT YOUR OWN RISK.\r\nDO NOT CHECK THIS BOX UNLESS YOU KNOW WHAT YOU ARE DOING.\r\nBy default Monitor Locations will not remonitor recorded videos that have been processed.\r\nCheck this box if you want to remonitor and reconvert the recorded videos.	如果您想要更改重新監視和重組錄製的視頻，檢查此框在您自己的 RISK.\r\nDO 不檢查此框除非你知道你是什麼 DOING.\r\nBy 預設監視器位置將不更改重新監視錄得了 processed.\r\nCheck 的視頻此框。
To avoid an infinite conversion loop, it is recommended that you enable Delete original file option in the Settings page.	為了避免無限轉換迴圈，建議您啟用刪除原始的檔選項，在設置頁中。
Prioritize air date matching	確定優先次序空氣日期匹配
MCEBuddy uses the episode name to match the series information\r\nwhile searching the internet. If that fails then it uses the original broadcast\r\nair date to match the metadata.\r\n\r\nCheck this box to use the original broadcast air date first and then the\r\nepisode name to match for the series information from the internet.\r\nThis can be useful in some cases when multiple seasons have the same\r\nepisode name. E.g. Americal Idol, Audition 1\r\n\r\nNOTE: Original broadcast air date is not always accurate set by the\r\nbroadcaster and sometimes the information on the internet is incorrect.\r\nUse this option only if the default option is not working for you.	MCEBuddy 使用的插曲名稱匹配在互聯網上尋找系列 information\r\nwhile。如果失敗然後它使用 broadcast\r\nair 的原始日期進行匹配的 metadata.\r\n\r\nCheck 此框，第一次使用的原始廣播的播出日期，然後 the\r\nepisode 從 internet.\r\nThis 系列資訊匹配的名稱可以在某些情況下非常有用時多個季節有 same\r\nepisode 的名稱。例如美國偶像海選 1\r\n\r\nNOTE： 原始廣播的播出日期並不總是準確設置的 the\r\nbroadcaster 和互聯網上的資訊有時是的 incorrect.\r\nUse 此選項僅當預設的選項不為你工作。
Skip eMail body	跳過電子郵件正文
Check this option to use an empty body in the notification eMail.\r\nThis can be useful if you're using a SMS gateway for eMail notifications.	請檢查此選項可在通知 eMail.\r\nThis 中使用一個空的機構可以是有用的如果您使用 SMS 閘道的電子郵件通知。
Selection based on Digital Right Management (DRM) is available\r\nonly when Rename without converting (Rename and move only) option is selected.\r\n\r\nAll - Selects all files for processing, irrespective of copy protection status\r\nProtected - Only select files which are copy protected\r\nUnprotected - Only select files which do not have copy protection	選擇基於數位權利管理 (DRM) 是 available\r\nonly 時不進行轉換，重命名 (重命名和移動只) 選項僅選擇檔有哪些副本 protected\r\nUnprotected selected.\r\n\r\nAll-選擇所有檔進行處理，無論禁止複製 status\r\nProtected--只能選擇，並不具有禁止複製的檔
Download cover art	下載封面藝術
Enable this to download the cover art from the original video and internet if available.	啟用此下載封面藝術從原始視頻和互聯網，如果可用。
Are you sure you want to enter a Domain Name?\r\n\r\nUse this ONLY if you are using a Windows Domain Controller to manage your authentication.\r\nDo NOT use this if you are part of a Workgroup.\r\n\r\nIf you are unsure click NO.	你是你想要輸入一個功能變數名稱嗎？ \r\n\r\nUse 這只有如果你使用 Windows 網域控制站來管理您的 authentication.\r\nDo 不使用此如果你是 Workgroup.\r\n\r\nIf 的一部分你號是不能確定按一下
Configuration Warning	配置警告
Creates a folder called 'MCEBuddyArchive' where the original file is located\r\nand moves the orginal file in this directory after a successful conversion.\r\n\r\nThis folder name and location be changed below.	創建一個資料夾，叫做 'MCEBuddyArchive' located\r\nand 移動此目錄中的原始檔案後成功 conversion.\r\n\r\nThis 資料夾名稱和位置在下面更改原始檔案在哪裡。
Monitoring	監測
If you want to convert the EDL file into chapters, make sure you check the 'Add Subtitles and Chapters' option in Expert Settings.	如果您想要該 EDL 檔轉換的章節，請務必檢查專家設置中的添加字幕和章的選項。
EDL to Chapters	EDL 的章節
